날짜,기업명,긍정,부정,중립,전체뉴스수,감성_긍정비율,감성_부정비율
2024-01-01,HD한국조선해양,13,8,4,25,0.6190475895691624,0.38095236281179223
2024-01-01,HD현대마린솔루션,3,1,0,4,0.7499998125000469,0.24999993750001562
2024-01-01,HD현대마린엔진,1,0,0,1,0.9999990000010001,0.0
2024-01-01,HD현대미포,10,2,0,12,0.8333332638888947,0.16666665277777895
2024-01-01,HD현대중공업,18,5,4,27,0.7826086616257103,0.21739129489603065
2024-01-01,STX엔진,0,2,1,3,0.0,0.99999950000025
2024-01-01,삼성중공업,15,6,2,23,0.7142856802721105,0.28571427210884415
2024-01-01,세진중공업,2,1,0,3,0.6666664444445185,0.33333322222225925
2024-01-01,한국카본,2,2,0,4,0.49999987500003124,0.49999987500003124
2024-01-01,한화엔진,4,6,0,10,0.39999996000000404,0.599999940000006
2024-01-01,한화오션,16,9,6,31,0.639999974400001,0.35999998560000057
2024-01-02,HD한국조선해양,15,4,1,20,0.7894736426592819,0.21052630470914185
2024-01-02,HD현대마린솔루션,7,4,1,12,0.636363578512402,0.3636363305785154
2024-01-02,HD현대마린엔진,1,1,0,2,0.499999750000125,0.499999750000125
2024-01-02,HD현대미포,9,1,0,10,0.8999999100000091,0.09999999000000101
2024-01-02,HD현대중공업,19,3,4,26,0.863636324380167,0.13636363016528952
2024-01-02,삼성중공업,18,2,2,22,0.8999999550000022,0.09999999500000024
2024-01-02,세진중공업,3,0,0,3,0.9999996666667778,0.0
2024-01-02,한화엔진,20,2,1,23,0.9090908677685968,0.09090908677685969
2024-01-02,한화오션,15,4,8,27,0.7894736426592819,0.21052630470914185
2024-01-03,HD한국조선해양,13,7,8,28,0.6499999675000016,0.34999998250000086
2024-01-03,HD현대마린솔루션,2,2,1,5,0.49999987500003124,0.49999987500003124
2024-01-03,HD현대마린엔진,0,1,0,1,0.0,0.9999990000010001
2024-01-03,HD현대미포,9,2,3,14,0.8181817438016598,0.1818181652892577
2024-01-03,HD현대중공업,19,5,6,30,0.7916666336805569,0.20833332465277812
2024-01-03,STX엔진,6,2,1,9,0.7499999062500118,0.24999996875000394
2024-01-03,삼성중공업,13,7,3,23,0.6499999675000016,0.34999998250000086
2024-01-03,세진중공업,6,1,1,8,0.857142734693895,0.1428571224489825
2024-01-03,한국카본,6,3,1,10,0.6666665925926009,0.33333329629630043
2024-01-03,한화엔진,15,5,1,21,0.7499999625000018,0.2499999875000006
2024-01-03,한화오션,20,9,4,33,0.689655148632581,0.3103448168846615
2024-01-04,HD한국조선해양,17,4,7,28,0.8095237709750585,0.19047618140589612
2024-01-04,HD현대마린솔루션,8,5,0,13,0.615384568047341,0.3846153550295881
2024-01-04,HD현대미포,7,1,6,14,0.8749998906250137,0.12499998437500197
2024-01-04,HD현대중공업,29,7,10,46,0.8055555331790131,0.19444443904321004
2024-01-04,STX엔진,2,1,0,3,0.6666664444445185,0.33333322222225925
2024-01-04,삼성중공업,10,5,5,20,0.6666666222222252,0.3333333111111126
2024-01-04,세진중공업,1,1,0,2,0.499999750000125,0.499999750000125
2024-01-04,한국카본,1,1,0,2,0.499999750000125,0.499999750000125
2024-01-04,한화엔진,17,2,2,21,0.8947367950138528,0.10526315235457093
2024-01-04,한화오션,20,10,10,40,0.6666666444444451,0.33333332222222256
2024-01-05,HD한국조선해양,46,4,5,55,0.9199999816000004,0.07999999840000004
2024-01-05,HD현대마린솔루션,4,4,0,8,0.4999999375000079,0.4999999375000079
2024-01-05,HD현대미포,7,1,3,11,0.8749998906250137,0.12499998437500197
2024-01-05,HD현대중공업,48,4,3,55,0.9230769053254442,0.07692307544378701
2024-01-05,STX엔진,1,1,0,2,0.499999750000125,0.499999750000125
2024-01-05,삼성중공업,13,4,8,25,0.7647058373702448,0.23529410380622917
2024-01-05,한화엔진,11,2,2,15,0.8461537810650938,0.15384614201183525
2024-01-05,한화오션,33,6,9,48,0.8461538244575944,0.1538461499013808
2024-01-06,HD한국조선해양,4,1,0,5,0.799999840000032,0.199999960000008
2024-01-06,HD현대마린솔루션,1,0,0,1,0.9999990000010001,0.0
2024-01-06,HD현대미포,0,1,0,1,0.0,0.9999990000010001
2024-01-06,HD현대중공업,4,2,0,6,0.6666665555555741,0.33333327777778704
2024-01-06,삼성중공업,4,1,0,5,0.799999840000032,0.199999960000008
2024-01-06,한화엔진,1,2,0,3,0.33333322222225925,0.6666664444445185
2024-01-06,한화오션,7,1,0,8,0.8749998906250137,0.12499998437500197
2024-01-07,HD한국조선해양,15,2,4,21,0.8823528892733594,0.11764705190311459
2024-01-07,HD현대마린솔루션,1,1,0,2,0.499999750000125,0.499999750000125
2024-01-07,HD현대미포,6,0,2,8,0.9999998333333611,0.0
2024-01-07,HD현대중공업,18,0,3,21,0.9999999444444475,0.0
2024-01-07,삼성중공업,16,2,8,26,0.8888888395061756,0.11111110493827195
2024-01-07,한화엔진,10,0,0,10,0.99999990000001,0.0
2024-01-07,한화오션,18,3,5,26,0.8571428163265326,0.14285713605442207
2024-01-08,HD한국조선해양,19,5,2,26,0.7916666336805569,0.20833332465277812
2024-01-08,HD현대마린솔루션,8,2,0,10,0.7999999200000081,0.19999998000000202
2024-01-08,HD현대마린엔진,1,1,0,2,0.499999750000125,0.499999750000125
2024-01-08,HD현대미포,6,0,0,6,0.9999998333333611,0.0
2024-01-08,HD현대중공업,20,10,1,31,0.6666666444444451,0.33333332222222256
2024-01-08,STX엔진,7,1,0,8,0.8749998906250137,0.12499998437500197
2024-01-08,삼성중공업,11,4,3,18,0.7333332844444478,0.2666666488888901
2024-01-08,세진중공업,1,1,1,3,0.499999750000125,0.499999750000125
2024-01-08,한국카본,1,1,0,2,0.499999750000125,0.499999750000125
2024-01-08,한화엔진,19,3,0,22,0.863636324380167,0.13636363016528952
2024-01-08,한화오션,19,6,2,27,0.7599999696000012,0.23999999040000036
2024-01-09,HD한국조선해양,16,6,3,25,0.7272726942148775,0.27272726033057904
2024-01-09,HD현대마린솔루션,8,4,0,12,0.6666666111111158,0.3333333055555579
2024-01-09,HD현대미포,12,0,2,14,0.9999999166666736,0.0
2024-01-09,HD현대중공업,25,1,3,29,0.9615384245562144,0.03846153698224858
2024-01-09,STX엔진,3,1,0,4,0.7499998125000469,0.24999993750001562
2024-01-09,삼성중공업,15,5,8,28,0.7499999625000018,0.2499999875000006
2024-01-09,세진중공업,4,0,7,11,0.9999997500000625,0.0
2024-01-09,한국카본,1,0,1,2,0.9999990000010001,0.0
2024-01-09,한화엔진,15,4,1,20,0.7894736426592819,0.21052630470914185
2024-01-09,한화오션,20,6,9,35,0.7692307396449716,0.23076922189349144
2024-01-10,HD한국조선해양,29,19,2,50,0.6041666540798614,0.39583332508680574
2024-01-10,HD현대마린솔루션,8,2,0,10,0.7999999200000081,0.19999998000000202
2024-01-10,HD현대마린엔진,1,0,0,1,0.9999990000010001,0.0
2024-01-10,HD현대미포,14,6,0,20,0.6999999650000017,0.29999998500000075
2024-01-10,HD현대중공업,45,9,2,56,0.8333333179012349,0.16666666358024698
2024-01-10,STX엔진,2,2,0,4,0.49999987500003124,0.49999987500003124
2024-01-10,삼성중공업,12,1,2,15,0.9230768520710114,0.07692307100591762
2024-01-10,세진중공업,2,1,1,4,0.6666664444445185,0.33333322222225925
2024-01-10,한국카본,2,1,0,3,0.6666664444445185,0.33333322222225925
2024-01-10,한화엔진,5,6,1,12,0.4545454132231443,0.5454544958677732
2024-01-10,한화오션,24,6,6,36,0.7999999733333342,0.19999999333333354
2024-01-11,HD한국조선해양,19,6,2,27,0.7599999696000012,0.23999999040000036
2024-01-11,HD현대마린솔루션,4,0,0,4,0.9999997500000625,0.0
2024-01-11,HD현대마린엔진,1,0,0,1,0.9999990000010001,0.0
2024-01-11,HD현대미포,7,3,0,10,0.699999930000007,0.299999970000003
2024-01-11,HD현대중공업,24,4,3,31,0.8571428265306134,0.14285713775510223
2024-01-11,STX엔진,0,1,0,1,0.0,0.9999990000010001
2024-01-11,삼성중공업,8,8,2,18,0.4999999687500019,0.4999999687500019
2024-01-11,한화엔진,7,6,1,14,0.5384614970414233,0.4615384260355057
2024-01-11,한화오션,21,8,3,32,0.7241379060642101,0.27586205945303244
2024-01-12,HD한국조선해양,19,6,0,25,0.7599999696000012,0.23999999040000036
2024-01-12,HD현대마린솔루션,7,2,2,11,0.7777776913580343,0.22222219753086697
2024-01-12,HD현대미포,4,5,1,10,0.44444439506173394,0.5555554938271674
2024-01-12,HD현대중공업,12,6,1,19,0.6666666296296316,0.3333333148148158
2024-01-12,STX엔진,1,2,0,3,0.33333322222225925,0.6666664444445185
2024-01-12,삼성중공업,16,4,6,26,0.799999960000002,0.1999999900000005
2024-01-12,세진중공업,4,2,0,6,0.6666665555555741,0.33333327777778704
2024-01-12,한국카본,4,4,0,8,0.4999999375000079,0.4999999375000079
2024-01-12,한화엔진,8,4,4,16,0.6666666111111158,0.3333333055555579
2024-01-12,한화오션,61,10,6,77,0.8591549174766914,0.14084506843880185
2024-01-13,HD한국조선해양,4,1,0,5,0.799999840000032,0.199999960000008
2024-01-13,HD현대중공업,9,1,0,10,0.8999999100000091,0.09999999000000101
2024-01-13,삼성중공업,2,0,1,3,0.99999950000025,0.0
2024-01-13,세진중공업,0,1,0,1,0.0,0.9999990000010001
2024-01-13,한화엔진,1,0,1,2,0.9999990000010001,0.0
2024-01-13,한화오션,12,1,1,14,0.9230768520710114,0.07692307100591762
2024-01-14,HD한국조선해양,5,3,1,9,0.6249999218750099,0.3749999531250059
2024-01-14,HD현대마린솔루션,1,1,1,3,0.499999750000125,0.499999750000125
2024-01-14,HD현대미포,1,0,0,1,0.9999990000010001,0.0
2024-01-14,HD현대중공업,10,1,0,11,0.9090908264462886,0.09090908264462885
2024-01-14,STX엔진,3,3,0,6,0.49999991666668053,0.49999991666668053
2024-01-14,삼성중공업,2,2,4,8,0.49999987500003124,0.49999987500003124
2024-01-14,세진중공업,0,1,0,1,0.0,0.9999990000010001
2024-01-14,한국카본,2,2,0,4,0.49999987500003124,0.49999987500003124
2024-01-14,한화엔진,4,2,1,7,0.6666665555555741,0.33333327777778704
2024-01-14,한화오션,9,4,1,14,0.6923076390532585,0.3076922840236705
2024-01-15,HD한국조선해양,13,6,1,20,0.684210490304711,0.31578945706371275
2024-01-15,HD현대마린솔루션,1,3,0,4,0.24999993750001562,0.7499998125000469
2024-01-15,HD현대미포,3,1,0,4,0.7499998125000469,0.24999993750001562
2024-01-15,HD현대중공업,20,10,0,30,0.6666666444444451,0.33333332222222256
2024-01-15,STX엔진,1,1,0,2,0.499999750000125,0.499999750000125
2024-01-15,삼성중공업,11,4,2,17,0.7333332844444478,0.2666666488888901
2024-01-15,세진중공업,2,1,1,4,0.6666664444445185,0.33333322222225925
2024-01-15,한국카본,1,1,0,2,0.499999750000125,0.499999750000125
2024-01-15,한화엔진,5,1,0,6,0.8333331944444675,0.16666663888889352
2024-01-15,한화오션,26,7,2,35,0.7878787640036738,0.21212120569329682
2024-01-16,HD한국조선해양,9,7,7,23,0.5624999648437522,0.4374999726562517
2024-01-16,HD현대마린솔루션,3,4,0,7,0.4285713673469475,0.57142848979593
2024-01-16,HD현대마린엔진,0,1,0,1,0.0,0.9999990000010001
2024-01-16,HD현대미포,3,0,1,4,0.9999996666667778,0.0
2024-01-16,HD현대중공업,21,7,3,31,0.7499999732142867,0.24999999107142887
2024-01-16,STX엔진,0,0,1,1,0.0,0.0
2024-01-16,삼성중공업,19,8,6,33,0.7037036776406045,0.2962962853223598
2024-01-16,세진중공업,0,1,0,1,0.0,0.9999990000010001
2024-01-16,한국카본,2,3,1,6,0.399999920000016,0.599999880000024
2024-01-16,한화엔진,10,2,2,14,0.8333332638888947,0.16666665277777895
2024-01-16,한화오션,30,9,7,46,0.769230749506904,0.2307692248520712
2024-01-17,HD한국조선해양,14,5,1,20,0.7368420664819965,0.26315788088642733
2024-01-17,HD현대마린솔루션,3,3,1,7,0.49999991666668053,0.49999991666668053
2024-01-17,HD현대미포,18,2,0,20,0.8999999550000022,0.09999999500000024
2024-01-17,HD현대중공업,15,6,4,25,0.7142856802721105,0.28571427210884415
2024-01-17,STX엔진,1,2,0,3,0.33333322222225925,0.6666664444445185
2024-01-17,삼성중공업,10,3,4,17,0.7692307100591762,0.23076921301775286
2024-01-17,세진중공업,1,0,0,1,0.9999990000010001,0.0
2024-01-17,한국카본,1,0,1,2,0.9999990000010001,0.0
2024-01-17,한화엔진,6,2,2,10,0.7499999062500118,0.24999996875000394
2024-01-17,한화오션,19,8,5,32,0.7037036776406045,0.2962962853223598
2024-01-18,HD한국조선해양,17,1,1,19,0.9444443919753115,0.055555552469135974
2024-01-18,HD현대마린솔루션,4,2,1,7,0.6666665555555741,0.33333327777778704
2024-01-18,HD현대마린엔진,1,0,0,1,0.9999990000010001,0.0
2024-01-18,HD현대미포,10,0,0,10,0.99999990000001,0.0
2024-01-18,HD현대중공업,20,1,3,24,0.9523809070294805,0.04761904535147403
2024-01-18,STX엔진,3,0,0,3,0.9999996666667778,0.0
2024-01-18,삼성중공업,29,3,6,38,0.9062499716796885,0.0937499970703126
2024-01-18,한국카본,1,2,0,3,0.33333322222225925,0.6666664444445185
2024-01-18,한화엔진,6,2,1,9,0.7499999062500118,0.24999996875000394
2024-01-18,한화오션,21,6,6,33,0.7777777489711944,0.22222221399176983
2024-01-19,HD한국조선해양,13,6,2,21,0.684210490304711,0.31578945706371275
2024-01-19,HD현대마린솔루션,7,1,0,8,0.8749998906250137,0.12499998437500197
2024-01-19,HD현대마린엔진,1,1,0,2,0.499999750000125,0.499999750000125
2024-01-19,HD현대미포,7,2,1,10,0.7777776913580343,0.22222219753086697
2024-01-19,HD현대중공업,47,8,2,57,0.8545454390082647,0.1454545428099174
2024-01-19,STX엔진,2,0,0,2,0.99999950000025,0.0
2024-01-19,삼성중공업,27,8,4,39,0.7714285493877557,0.22857142204081654
2024-01-19,세진중공업,1,1,0,2,0.499999750000125,0.499999750000125
2024-01-19,한국카본,3,1,1,5,0.7499998125000469,0.24999993750001562
2024-01-19,한화엔진,6,4,0,10,0.599999940000006,0.39999996000000404
2024-01-19,한화오션,17,5,4,26,0.7727272376033073,0.2272727169421492
2024-01-20,HD한국조선해양,5,3,1,9,0.6249999218750099,0.3749999531250059
2024-01-20,HD현대마린솔루션,2,1,0,3,0.6666664444445185,0.33333322222225925
2024-01-20,HD현대미포,2,0,0,2,0.99999950000025,0.0
2024-01-20,HD현대중공업,8,1,1,10,0.8888887901234679,0.11111109876543349
2024-01-20,STX엔진,1,0,0,1,0.9999990000010001,0.0
2024-01-20,삼성중공업,5,2,0,7,0.7142856122449125,0.285714244897965
2024-01-20,한화엔진,1,0,0,1,0.9999990000010001,0.0
2024-01-20,한화오션,7,0,1,8,0.9999998571428775,0.0
2024-01-21,HD한국조선해양,4,2,2,8,0.6666665555555741,0.33333327777778704
2024-01-21,HD현대미포,2,3,0,5,0.399999920000016,0.599999880000024
2024-01-21,HD현대중공업,9,2,2,13,0.8181817438016598,0.1818181652892577
2024-01-21,삼성중공업,6,2,3,11,0.7499999062500118,0.24999996875000394
2024-01-21,한화엔진,5,0,0,5,0.99999980000004,0.0
2024-01-21,한화오션,8,2,3,13,0.7999999200000081,0.19999998000000202
2024-01-22,HD한국조선해양,27,3,11,41,0.899999970000001,0.09999999666666677
2024-01-22,HD현대마린솔루션,16,3,1,20,0.8421052188365674,0.15789472853185638
2024-01-22,HD현대미포,2,2,1,5,0.49999987500003124,0.49999987500003124
2024-01-22,HD현대중공업,66,14,10,90,0.8249999896875001,0.17499999781250003
2024-01-22,삼성중공업,14,9,4,27,0.6086956257088858,0.39130433081285515
2024-01-22,세진중공업,1,0,0,1,0.9999990000010001,0.0
2024-01-22,한국카본,7,2,0,9,0.7777776913580343,0.22222219753086697
2024-01-22,한화엔진,9,4,1,14,0.6923076390532585,0.3076922840236705
2024-01-22,한화오션,61,22,12,95,0.7349397501814489,0.2650602377703586
2024-01-23,HD한국조선해양,21,5,4,30,0.8076922766272201,0.1923076849112429
2024-01-23,HD현대마린솔루션,8,2,0,10,0.7999999200000081,0.19999998000000202
2024-01-23,HD현대미포,1,2,2,5,0.33333322222225925,0.6666664444445185
2024-01-23,HD현대중공업,19,11,5,35,0.6333333122222229,0.36666665444444485
2024-01-23,STX엔진,0,0,1,1,0.0,0.0
2024-01-23,삼성중공업,15,7,6,28,0.6818181508264477,0.3181818037190089
2024-01-23,세진중공업,0,1,1,2,0.0,0.9999990000010001
2024-01-23,한국카본,2,0,1,3,0.99999950000025,0.0
2024-01-23,한화엔진,4,3,1,8,0.57142848979593,0.4285713673469475
2024-01-23,한화오션,15,8,6,29,0.6521738846880919,0.34782607183364905
2024-01-24,HD한국조선해양,19,6,2,27,0.7599999696000012,0.23999999040000036
2024-01-24,HD현대마린솔루션,7,1,0,8,0.8749998906250137,0.12499998437500197
2024-01-24,HD현대미포,9,1,2,12,0.8999999100000091,0.09999999000000101
2024-01-24,HD현대중공업,38,9,4,51,0.8085106210955187,0.19148935762788602
2024-01-24,STX엔진,2,0,0,2,0.99999950000025,0.0
2024-01-24,삼성중공업,14,6,4,24,0.6999999650000017,0.29999998500000075
2024-01-24,세진중공업,1,0,0,1,0.9999990000010001,0.0
2024-01-24,한국카본,1,0,0,1,0.9999990000010001,0.0
2024-01-24,한화엔진,8,2,0,10,0.7999999200000081,0.19999998000000202
2024-01-24,한화오션,33,7,9,49,0.8249999793750006,0.17499999562500013
2024-01-25,HD한국조선해양,10,7,0,17,0.588235259515573,0.4117646816609011
2024-01-25,HD현대마린솔루션,1,1,0,2,0.499999750000125,0.499999750000125
2024-01-25,HD현대미포,7,2,0,9,0.7777776913580343,0.22222219753086697
2024-01-25,HD현대중공업,19,7,1,27,0.7307692026627229,0.26923075887574005
2024-01-25,삼성중공업,7,6,3,16,0.5384614970414233,0.4615384260355057
2024-01-25,세진중공업,1,0,0,1,0.9999990000010001,0.0
2024-01-25,한국카본,2,1,0,3,0.6666664444445185,0.33333322222225925
2024-01-25,한화엔진,9,1,0,10,0.8999999100000091,0.09999999000000101
2024-01-25,한화오션,17,13,6,36,0.5666666477777784,0.4333333188888894
2024-01-26,HD한국조선해양,16,4,1,21,0.799999960000002,0.1999999900000005
2024-01-26,HD현대마린솔루션,1,3,2,6,0.24999993750001562,0.7499998125000469
2024-01-26,HD현대미포,5,1,2,8,0.8333331944444675,0.16666663888889352
2024-01-26,HD현대중공업,13,6,4,23,0.684210490304711,0.31578945706371275
2024-01-26,STX엔진,1,1,0,2,0.499999750000125,0.499999750000125
2024-01-26,삼성중공업,15,4,3,22,0.7894736426592819,0.21052630470914185
2024-01-26,세진중공업,1,2,0,3,0.33333322222225925,0.6666664444445185
2024-01-26,한국카본,3,4,2,9,0.4285713673469475,0.57142848979593
2024-01-26,한화엔진,6,2,1,9,0.7499999062500118,0.24999996875000394
2024-01-26,한화오션,24,2,4,30,0.9230768875739658,0.07692307396449716
2024-01-27,HD한국조선해양,2,3,0,5,0.399999920000016,0.599999880000024
2024-01-27,HD현대마린솔루션,1,0,0,1,0.9999990000010001,0.0
2024-01-27,HD현대미포,1,0,1,2,0.9999990000010001,0.0
2024-01-27,HD현대중공업,1,1,1,3,0.499999750000125,0.499999750000125
2024-01-27,삼성중공업,6,1,1,8,0.857142734693895,0.1428571224489825
2024-01-27,한화오션,7,1,1,9,0.8749998906250137,0.12499998437500197
2024-01-28,HD한국조선해양,1,3,2,6,0.24999993750001562,0.7499998125000469
2024-01-28,HD현대마린솔루션,3,1,0,4,0.7499998125000469,0.24999993750001562
2024-01-28,HD현대미포,0,2,0,2,0.0,0.99999950000025
2024-01-28,HD현대중공업,9,4,1,14,0.6923076390532585,0.3076922840236705
2024-01-28,삼성중공업,2,1,3,6,0.6666664444445185,0.33333322222225925
2024-01-28,한화엔진,1,1,1,3,0.499999750000125,0.499999750000125
2024-01-28,한화오션,4,2,3,9,0.6666665555555741,0.33333327777778704
2024-01-29,HD한국조선해양,15,9,4,28,0.6249999739583344,0.37499998437500065
2024-01-29,HD현대마린솔루션,15,5,0,20,0.7499999625000018,0.2499999875000006
2024-01-29,HD현대마린엔진,19,1,0,20,0.9499999525000024,0.04999999750000012
2024-01-29,HD현대미포,4,1,5,10,0.799999840000032,0.199999960000008
2024-01-29,HD현대중공업,75,10,6,91,0.8823529307958479,0.11764705743944638
2024-01-29,삼성중공업,12,4,7,23,0.7499999531250029,0.24999998437500096
2024-01-29,세진중공업,0,1,0,1,0.0,0.9999990000010001
2024-01-29,한화엔진,12,2,2,16,0.8571427959183717,0.14285713265306196
2024-01-29,한화오션,26,10,5,41,0.7222222021604945,0.2777777700617286
2024-01-30,HD한국조선해양,11,7,3,21,0.6111110771604957,0.3888888672839518
2024-01-30,HD현대마린솔루션,8,2,0,10,0.7999999200000081,0.19999998000000202
2024-01-30,HD현대마린엔진,9,1,0,10,0.8999999100000091,0.09999999000000101
2024-01-30,HD현대미포,14,0,1,15,0.9999999285714337,0.0
2024-01-30,HD현대중공업,22,5,3,30,0.8148147846364894,0.18518517832647488
2024-01-30,삼성중공업,11,5,4,20,0.6874999570312527,0.3124999804687512
2024-01-30,한국카본,1,0,0,1,0.9999990000010001,0.0
2024-01-30,한화엔진,10,3,1,14,0.7692307100591762,0.23076921301775286
2024-01-30,한화오션,21,10,6,37,0.677419332986473,0.3225806347554634
2024-01-31,HD한국조선해양,19,4,1,24,0.8260869206049165,0.17391303591682453
2024-01-31,HD현대마린솔루션,2,0,1,3,0.99999950000025,0.0
2024-01-31,HD현대마린엔진,1,0,0,1,0.9999990000010001,0.0
2024-01-31,HD현대미포,8,0,0,8,0.9999998750000157,0.0
2024-01-31,HD현대중공업,25,3,3,31,0.8928571109693889,0.10714285331632667
2024-01-31,STX엔진,1,2,0,3,0.33333322222225925,0.6666664444445185
2024-01-31,삼성중공업,12,4,6,22,0.7499999531250029,0.24999998437500096
2024-01-31,세진중공업,1,1,0,2,0.499999750000125,0.499999750000125
2024-01-31,한국카본,1,1,0,2,0.499999750000125,0.499999750000125
2024-01-31,한화엔진,5,2,1,8,0.7142856122449125,0.285714244897965
2024-01-31,한화오션,50,6,6,62,0.8928571269132657,0.10714285522959188
2024-02-01,HD한국조선해양,18,3,0,21,0.8571428163265326,0.14285713605442207
2024-02-01,HD현대마린솔루션,18,1,1,20,0.9473683711911383,0.05263157617728546
2024-02-01,HD현대미포,10,0,0,10,0.99999990000001,0.0
2024-02-01,HD현대중공업,17,4,1,22,0.8095237709750585,0.19047618140589612
2024-02-01,STX엔진,0,2,0,2,0.0,0.99999950000025
2024-02-01,삼성중공업,5,6,2,13,0.4545454132231443,0.5454544958677732
2024-02-01,한국카본,0,1,0,1,0.0,0.9999990000010001
2024-02-01,한화엔진,2,5,2,9,0.285714244897965,0.7142856122449125
2024-02-01,한화오션,20,1,1,22,0.9523809070294805,0.04761904535147403
2024-02-02,HD한국조선해양,14,7,2,23,0.6666666349206364,0.3333333174603182
2024-02-02,HD현대마린솔루션,19,1,0,20,0.9499999525000024,0.04999999750000012
2024-02-02,HD현대마린엔진,1,0,0,1,0.9999990000010001,0.0
2024-02-02,HD현대미포,15,4,1,20,0.7894736426592819,0.21052630470914185
2024-02-02,HD현대중공업,29,12,0,41,0.7073170559190962,0.2926829196906605
2024-02-02,STX엔진,3,4,1,8,0.4285713673469475,0.57142848979593
2024-02-02,삼성중공업,15,4,0,19,0.7894736426592819,0.21052630470914185
2024-02-02,세진중공업,3,4,1,8,0.4285713673469475,0.57142848979593
2024-02-02,한국카본,5,4,1,10,0.5555554938271674,0.44444439506173394
2024-02-02,한화엔진,6,5,1,12,0.5454544958677732,0.4545454132231443
2024-02-02,한화오션,13,11,1,25,0.5416666440972231,0.4583333142361119
2024-02-03,HD한국조선해양,6,3,1,10,0.6666665925926009,0.33333329629630043
2024-02-03,HD현대마린솔루션,6,0,0,6,0.9999998333333611,0.0
2024-02-03,HD현대미포,4,0,0,4,0.9999997500000625,0.0
2024-02-03,HD현대중공업,5,0,1,6,0.99999980000004,0.0
2024-02-03,STX엔진,0,1,0,1,0.0,0.9999990000010001
2024-02-03,삼성중공업,3,2,1,6,0.599999880000024,0.399999920000016
2024-02-03,한국카본,1,0,0,1,0.9999990000010001,0.0
2024-02-03,한화엔진,0,2,0,2,0.0,0.99999950000025
2024-02-03,한화오션,2,2,0,4,0.49999987500003124,0.49999987500003124
2024-02-04,HD한국조선해양,10,3,0,13,0.7692307100591762,0.23076921301775286
2024-02-04,HD현대마린솔루션,8,4,0,12,0.6666666111111158,0.3333333055555579
2024-02-04,HD현대마린엔진,1,0,0,1,0.9999990000010001,0.0
2024-02-04,HD현대미포,3,1,0,4,0.7499998125000469,0.24999993750001562
2024-02-04,HD현대중공업,17,3,0,20,0.8499999575000021,0.14999999250000037
2024-02-04,삼성중공업,6,2,0,8,0.7499999062500118,0.24999996875000394
2024-02-04,한화엔진,11,1,0,12,0.9166665902777842,0.08333332638888948
2024-02-04,한화오션,16,2,0,18,0.8888888395061756,0.11111110493827195
2024-02-05,HD한국조선해양,19,4,2,25,0.8260869206049165,0.17391303591682453
2024-02-05,HD현대마린솔루션,8,2,0,10,0.7999999200000081,0.19999998000000202
2024-02-05,HD현대미포,6,2,0,8,0.7499999062500118,0.24999996875000394
2024-02-05,HD현대중공업,43,11,1,55,0.7962962815500689,0.20370369993141296
2024-02-05,STX엔진,0,1,0,1,0.0,0.9999990000010001
2024-02-05,삼성중공업,15,2,2,19,0.8823528892733594,0.11764705190311459
2024-02-05,세진중공업,0,1,0,1,0.0,0.9999990000010001
2024-02-05,한국카본,0,1,0,1,0.0,0.9999990000010001
2024-02-05,한화엔진,18,5,0,23,0.7826086616257103,0.21739129489603065
2024-02-05,한화오션,33,6,1,40,0.8461538244575944,0.1538461499013808
2024-02-06,HD한국조선해양,47,19,11,77,0.7121212013314969,0.28787878351698815
2024-02-06,HD현대마린솔루션,15,8,10,33,0.6521738846880919,0.34782607183364905
2024-02-06,HD현대마린엔진,9,6,5,20,0.5999999600000027,0.39999997333333515
2024-02-06,HD현대미포,13,13,6,32,0.49999998076923147,0.49999998076923147
2024-02-06,HD현대중공업,54,21,11,86,0.7199999904000002,0.2799999962666667
2024-02-06,STX엔진,0,1,0,1,0.0,0.9999990000010001
2024-02-06,삼성중공업,22,6,12,40,0.7857142576530622,0.21428570663265334
2024-02-06,세진중공업,1,1,0,2,0.499999750000125,0.499999750000125
2024-02-06,한국카본,1,1,0,2,0.499999750000125,0.499999750000125
2024-02-06,한화엔진,6,6,2,14,0.4999999583333368,0.4999999583333368
2024-02-06,한화오션,20,4,9,33,0.8333332986111125,0.1666666597222225
2024-02-07,HD한국조선해양,24,11,2,37,0.6857142661224496,0.3142857053061227
2024-02-07,HD현대마린솔루션,7,3,0,10,0.699999930000007,0.299999970000003
2024-02-07,HD현대마린엔진,5,2,0,7,0.7142856122449125,0.285714244897965
2024-02-07,HD현대미포,14,4,1,19,0.7777777345679036,0.2222222098765439
2024-02-07,HD현대중공업,37,16,2,55,0.6981131943752228,0.3018867867568531
2024-02-07,STX엔진,2,2,1,5,0.49999987500003124,0.49999987500003124
2024-02-07,삼성중공업,21,16,3,40,0.567567552227904,0.4324324207450697
2024-02-07,세진중공업,2,1,0,3,0.6666664444445185,0.33333322222225925
2024-02-07,한국카본,1,2,1,4,0.33333322222225925,0.6666664444445185
2024-02-07,한화엔진,11,8,1,20,0.5789473379501401,0.4210526094182837
2024-02-07,한화오션,30,11,6,47,0.7317072992266512,0.26829267638310544
2024-02-08,HD한국조선해양,13,3,3,19,0.8124999492187531,0.18749998828125072
2024-02-08,HD현대마린솔루션,6,3,0,9,0.6666665925926009,0.33333329629630043
2024-02-08,HD현대마린엔진,1,0,0,1,0.9999990000010001,0.0
2024-02-08,HD현대미포,11,1,0,12,0.9166665902777842,0.08333332638888948
2024-02-08,HD현대중공업,15,8,0,23,0.6521738846880919,0.34782607183364905
2024-02-08,STX엔진,0,1,0,1,0.0,0.9999990000010001
2024-02-08,삼성중공업,18,8,2,28,0.6923076656804744,0.30769229585798863
2024-02-08,한화엔진,12,2,2,16,0.8571427959183717,0.14285713265306196
2024-02-08,한화오션,21,8,4,33,0.7241379060642101,0.27586205945303244
2024-02-09,HD한국조선해양,0,2,0,2,0.0,0.99999950000025
2024-02-09,HD현대미포,1,0,0,1,0.9999990000010001,0.0
2024-02-09,HD현대중공업,2,0,1,3,0.99999950000025,0.0
2024-02-09,삼성중공업,2,6,1,9,0.24999996875000394,0.7499999062500118
2024-02-09,한국카본,0,1,0,1,0.0,0.9999990000010001
2024-02-09,한화엔진,2,0,0,2,0.99999950000025,0.0
2024-02-09,한화오션,7,3,0,10,0.699999930000007,0.299999970000003
2024-02-10,HD한국조선해양,5,1,0,6,0.8333331944444675,0.16666663888889352
2024-02-10,HD현대마린솔루션,3,4,0,7,0.4285713673469475,0.57142848979593
2024-02-10,HD현대미포,2,0,0,2,0.99999950000025,0.0
2024-02-10,HD현대중공업,7,2,0,9,0.7777776913580343,0.22222219753086697
2024-02-10,STX엔진,0,1,0,1,0.0,0.9999990000010001
2024-02-10,삼성중공업,5,0,0,5,0.99999980000004,0.0
2024-02-10,한화엔진,3,8,0,11,0.2727272479338866,0.7272726611570308
2024-02-10,한화오션,6,3,0,9,0.6666665925926009,0.33333329629630043
2024-02-11,HD한국조선해양,9,2,0,11,0.8181817438016598,0.1818181652892577
2024-02-11,HD현대마린솔루션,3,1,0,4,0.7499998125000469,0.24999993750001562
2024-02-11,HD현대미포,1,1,0,2,0.499999750000125,0.499999750000125
2024-02-11,HD현대중공업,7,1,0,8,0.8749998906250137,0.12499998437500197
2024-02-11,STX엔진,2,0,0,2,0.99999950000025,0.0
2024-02-11,삼성중공업,4,3,1,8,0.57142848979593,0.4285713673469475
2024-02-11,세진중공업,1,0,0,1,0.9999990000010001,0.0
2024-02-11,한화엔진,5,0,0,5,0.99999980000004,0.0
2024-02-11,한화오션,6,4,0,10,0.599999940000006,0.39999996000000404
2024-02-12,HD한국조선해양,4,4,2,10,0.4999999375000079,0.4999999375000079
2024-02-12,HD현대마린솔루션,6,3,1,10,0.6666665925926009,0.33333329629630043
2024-02-12,HD현대미포,0,1,0,1,0.0,0.9999990000010001
2024-02-12,HD현대중공업,6,9,2,17,0.39999997333333515,0.5999999600000027
2024-02-12,삼성중공업,15,3,4,22,0.8333332870370396,0.1666666574074079
2024-02-12,세진중공업,0,1,0,1,0.0,0.9999990000010001
2024-02-12,한국카본,0,1,0,1,0.0,0.9999990000010001
2024-02-12,한화엔진,7,0,0,7,0.9999998571428775,0.0
2024-02-12,한화오션,16,3,2,21,0.8421052188365674,0.15789472853185638
2024-02-13,HD한국조선해양,12,6,7,25,0.6666666296296316,0.3333333148148158
2024-02-13,HD현대마린솔루션,5,1,2,8,0.8333331944444675,0.16666663888889352
2024-02-13,HD현대미포,6,4,1,11,0.599999940000006,0.39999996000000404
2024-02-13,HD현대중공업,26,13,18,57,0.6666666495726501,0.33333332478632505
2024-02-13,STX엔진,1,0,1,2,0.9999990000010001,0.0
2024-02-13,삼성중공업,16,3,8,27,0.8421052188365674,0.15789472853185638
2024-02-13,세진중공업,1,1,1,3,0.499999750000125,0.499999750000125
2024-02-13,한국카본,1,0,1,2,0.9999990000010001,0.0
2024-02-13,한화엔진,11,2,0,13,0.8461537810650938,0.15384614201183525
2024-02-13,한화오션,23,13,11,47,0.6388888711419759,0.36111110108024724
2024-02-14,HD한국조선해양,49,3,6,58,0.9423076741863909,0.05769230658284026
2024-02-14,HD현대마린솔루션,4,3,0,7,0.57142848979593,0.4285713673469475
2024-02-14,HD현대미포,6,3,0,9,0.6666665925926009,0.33333329629630043
2024-02-14,HD현대중공업,15,2,4,21,0.8823528892733594,0.11764705190311459
2024-02-14,STX엔진,1,0,0,1,0.9999990000010001,0.0
2024-02-14,삼성중공업,10,5,3,18,0.6666666222222252,0.3333333111111126
2024-02-14,세진중공업,1,0,0,1,0.9999990000010001,0.0
2024-02-14,한국카본,1,1,0,2,0.499999750000125,0.499999750000125
2024-02-14,한화엔진,9,1,3,13,0.8999999100000091,0.09999999000000101
2024-02-14,한화오션,35,7,11,53,0.833333313492064,0.1666666626984128
2024-02-15,HD한국조선해양,10,3,5,18,0.7692307100591762,0.23076921301775286
2024-02-15,HD현대마린솔루션,2,2,0,4,0.49999987500003124,0.49999987500003124
2024-02-15,HD현대미포,2,0,3,5,0.99999950000025,0.0
2024-02-15,HD현대중공업,16,2,11,29,0.8888888395061756,0.11111110493827195
2024-02-15,STX엔진,0,1,0,1,0.0,0.9999990000010001
2024-02-15,삼성중공업,10,3,7,20,0.7692307100591762,0.23076921301775286
2024-02-15,한화엔진,13,4,1,18,0.7647058373702448,0.23529410380622917
2024-02-15,한화오션,28,10,12,50,0.7368420858725767,0.26315788781163457
2024-02-16,HD한국조선해양,9,2,0,11,0.8181817438016598,0.1818181652892577
2024-02-16,HD현대마린솔루션,3,3,1,7,0.49999991666668053,0.49999991666668053
2024-02-16,HD현대미포,9,0,1,10,0.9999998888889013,0.0
2024-02-16,HD현대중공업,13,1,7,21,0.9285713622449028,0.07142856632653098
2024-02-16,STX엔진,1,0,0,1,0.9999990000010001,0.0
2024-02-16,삼성중공업,7,4,4,15,0.636363578512402,0.3636363305785154
2024-02-16,세진중공업,1,0,0,1,0.9999990000010001,0.0
2024-02-16,한국카본,1,0,0,1,0.9999990000010001,0.0
2024-02-16,한화엔진,8,1,1,10,0.8888887901234679,0.11111109876543349
2024-02-16,한화오션,10,5,5,20,0.6666666222222252,0.3333333111111126
2024-02-17,HD한국조선해양,8,1,0,9,0.8888887901234679,0.11111109876543349
2024-02-17,HD현대마린솔루션,2,0,0,2,0.99999950000025,0.0
2024-02-17,HD현대미포,1,0,0,1,0.9999990000010001,0.0
2024-02-17,HD현대중공업,8,1,1,10,0.8888887901234679,0.11111109876543349
2024-02-17,삼성중공업,4,2,1,7,0.6666665555555741,0.33333327777778704
2024-02-17,한화엔진,2,1,0,3,0.6666664444445185,0.33333322222225925
2024-02-17,한화오션,8,1,1,10,0.8888887901234679,0.11111109876543349
2024-02-18,HD한국조선해양,2,2,1,5,0.49999987500003124,0.49999987500003124
2024-02-18,HD현대마린솔루션,1,1,0,2,0.499999750000125,0.499999750000125
2024-02-18,HD현대미포,4,0,0,4,0.9999997500000625,0.0
2024-02-18,HD현대중공업,10,1,3,14,0.9090908264462886,0.09090908264462885
2024-02-18,삼성중공업,1,1,4,6,0.499999750000125,0.499999750000125
2024-02-18,한화엔진,2,0,1,3,0.99999950000025,0.0
2024-02-18,한화오션,4,2,4,10,0.6666665555555741,0.33333327777778704
2024-02-19,HD한국조선해양,13,3,1,17,0.8124999492187531,0.18749998828125072
2024-02-19,HD현대마린솔루션,8,2,0,10,0.7999999200000081,0.19999998000000202
2024-02-19,HD현대미포,3,1,0,4,0.7499998125000469,0.24999993750001562
2024-02-19,HD현대중공업,17,2,3,22,0.8947367950138528,0.10526315235457093
2024-02-19,STX엔진,1,1,1,3,0.499999750000125,0.499999750000125
2024-02-19,삼성중공업,13,2,1,16,0.8666666088888928,0.13333332444444504
2024-02-19,한국카본,1,1,0,2,0.499999750000125,0.499999750000125
2024-02-19,한화엔진,13,2,2,17,0.8666666088888928,0.13333332444444504
2024-02-19,한화오션,15,4,3,22,0.7894736426592819,0.21052630470914185
2024-02-20,HD한국조선해양,21,0,8,29,0.9999999523809546,0.0
2024-02-20,HD현대마린솔루션,8,2,0,10,0.7999999200000081,0.19999998000000202
2024-02-20,HD현대마린엔진,3,0,0,3,0.9999996666667778,0.0
2024-02-20,HD현대미포,2,0,1,3,0.99999950000025,0.0
2024-02-20,HD현대중공업,28,1,6,35,0.9655172080856135,0.034482757431629055
2024-02-20,삼성중공업,14,3,3,20,0.8235293633218022,0.17647057785467188
2024-02-20,한국카본,1,0,0,1,0.9999990000010001,0.0
2024-02-20,한화엔진,6,2,2,10,0.7499999062500118,0.24999996875000394
2024-02-20,한화오션,50,2,9,61,0.9615384430473377,0.03846153772189351
2024-02-21,HD한국조선해양,13,9,7,29,0.590909064049588,0.4090908904958686
2024-02-21,HD현대마린솔루션,4,2,1,7,0.6666665555555741,0.33333327777778704
2024-02-21,HD현대마린엔진,1,1,1,3,0.499999750000125,0.499999750000125
2024-02-21,HD현대미포,7,1,2,10,0.8749998906250137,0.12499998437500197
2024-02-21,HD현대중공업,63,8,9,80,0.8873239311644517,0.11267605475104149
2024-02-21,STX엔진,1,2,0,3,0.33333322222225925,0.6666664444445185
2024-02-21,삼성중공업,15,5,9,29,0.7499999625000018,0.2499999875000006
2024-02-21,세진중공업,1,2,0,3,0.33333322222225925,0.6666664444445185
2024-02-21,한국카본,1,1,0,2,0.499999750000125,0.499999750000125
2024-02-21,한화엔진,9,1,2,12,0.8999999100000091,0.09999999000000101
2024-02-21,한화오션,35,13,8,56,0.7291666514756948,0.27083332769097235
2024-02-22,HD한국조선해양,21,5,6,32,0.8076922766272201,0.1923076849112429
2024-02-22,HD현대마린솔루션,13,5,2,20,0.7222221820987677,0.27777776234567986
2024-02-22,HD현대마린엔진,3,0,1,4,0.9999996666667778,0.0
2024-02-22,HD현대미포,8,1,1,10,0.8888887901234679,0.11111109876543349
2024-02-22,HD현대중공업,26,6,6,38,0.8124999746093758,0.1874999941406252
2024-02-22,STX엔진,1,3,0,4,0.24999993750001562,0.7499998125000469
2024-02-22,삼성중공업,14,4,6,24,0.7777777345679036,0.2222222098765439
2024-02-22,세진중공업,0,1,0,1,0.0,0.9999990000010001
2024-02-22,한국카본,1,0,0,1,0.9999990000010001,0.0
2024-02-22,한화엔진,19,4,3,26,0.8260869206049165,0.17391303591682453
2024-02-22,한화오션,61,19,8,88,0.7624999904687502,0.23749999703125005
2024-02-23,HD한국조선해양,14,8,2,24,0.6363636074380178,0.36363634710743875
2024-02-23,HD현대마린솔루션,6,3,1,10,0.6666665925926009,0.33333329629630043
2024-02-23,HD현대마린엔진,0,1,0,1,0.0,0.9999990000010001
2024-02-23,HD현대미포,6,2,1,9,0.7499999062500118,0.24999996875000394
2024-02-23,HD현대중공업,17,2,2,21,0.8947367950138528,0.10526315235457093
2024-02-23,STX엔진,2,1,0,3,0.6666664444445185,0.33333322222225925
2024-02-23,삼성중공업,13,6,1,20,0.684210490304711,0.31578945706371275
2024-02-23,세진중공업,1,0,0,1,0.9999990000010001,0.0
2024-02-23,한국카본,1,0,0,1,0.9999990000010001,0.0
2024-02-23,한화엔진,16,4,3,23,0.799999960000002,0.1999999900000005
2024-02-23,한화오션,46,11,3,60,0.8070175297014469,0.1929824527546938
2024-02-24,HD한국조선해양,5,3,0,8,0.6249999218750099,0.3749999531250059
2024-02-24,HD현대미포,1,1,0,2,0.499999750000125,0.499999750000125
2024-02-24,HD현대중공업,2,4,2,8,0.33333327777778704,0.6666665555555741
2024-02-24,삼성중공업,2,4,1,7,0.33333327777778704,0.6666665555555741
2024-02-24,한화엔진,3,1,2,6,0.7499998125000469,0.24999993750001562
2024-02-24,한화오션,8,5,0,13,0.615384568047341,0.3846153550295881
2024-02-25,HD한국조선해양,11,0,1,12,0.9999999090909174,0.0
2024-02-25,HD현대마린솔루션,0,2,0,2,0.0,0.99999950000025
2024-02-25,HD현대미포,1,1,0,2,0.499999750000125,0.499999750000125
2024-02-25,HD현대중공업,8,1,1,10,0.8888887901234679,0.11111109876543349
2024-02-25,삼성중공업,8,1,1,10,0.8888887901234679,0.11111109876543349
2024-02-25,한화엔진,3,0,1,4,0.9999996666667778,0.0
2024-02-25,한화오션,10,3,1,14,0.7692307100591762,0.23076921301775286
2024-02-26,HD한국조선해양,20,6,7,33,0.7692307396449716,0.23076922189349144
2024-02-26,HD현대마린솔루션,6,3,1,10,0.6666665925926009,0.33333329629630043
2024-02-26,HD현대미포,5,2,2,9,0.7142856122449125,0.285714244897965
2024-02-26,HD현대중공업,29,5,3,37,0.8529411513840839,0.1470588192041524
2024-02-26,STX엔진,2,0,0,2,0.99999950000025,0.0
2024-02-26,삼성중공업,9,6,3,18,0.5999999600000027,0.39999997333333515
2024-02-26,세진중공업,0,3,0,3,0.0,0.9999996666667778
2024-02-26,한국카본,2,0,0,2,0.99999950000025,0.0
2024-02-26,한화엔진,9,3,1,13,0.7499999375000053,0.2499999791666684
2024-02-26,한화오션,25,8,7,40,0.7575757346189171,0.2424242350780535
2024-02-27,HD한국조선해양,19,12,9,40,0.6129032060353804,0.38709676170655605
2024-02-27,HD현대마린솔루션,2,3,4,9,0.399999920000016,0.599999880000024
2024-02-27,HD현대미포,9,3,0,12,0.7499999375000053,0.2499999791666684
2024-02-27,HD현대중공업,43,12,14,69,0.781818167603306,0.21818181421487612
2024-02-27,STX엔진,0,4,0,4,0.0,0.9999997500000625
2024-02-27,삼성중공업,7,9,11,27,0.4374999726562517,0.5624999648437522
2024-02-27,세진중공업,0,3,1,4,0.0,0.9999996666667778
2024-02-27,한국카본,0,3,0,3,0.0,0.9999996666667778
2024-02-27,한화엔진,4,5,3,12,0.44444439506173394,0.5555554938271674
2024-02-27,한화오션,17,12,11,40,0.5862068763376939,0.41379308917954866
2024-02-28,HD한국조선해양,48,6,6,60,0.8888888724279839,0.11111110905349798
2024-02-28,HD현대마린솔루션,7,1,2,10,0.8749998906250137,0.12499998437500197
2024-02-28,HD현대마린엔진,2,0,0,2,0.99999950000025,0.0
2024-02-28,HD현대미포,11,2,0,13,0.8461537810650938,0.15384614201183525
2024-02-28,HD현대중공업,137,13,3,153,0.9133333272444445,0.0866666660888889
2024-02-28,STX엔진,1,1,0,2,0.499999750000125,0.499999750000125
2024-02-28,삼성중공업,18,13,3,34,0.5806451425598341,0.4193548251821024
2024-02-28,세진중공업,2,1,0,3,0.6666664444445185,0.33333322222225925
2024-02-28,한국카본,3,1,0,4,0.7499998125000469,0.24999993750001562
2024-02-28,한화엔진,17,4,2,23,0.8095237709750585,0.19047618140589612
2024-02-28,한화오션,94,16,7,117,0.8545454467768596,0.1454545441322314
2024-02-29,HD한국조선해양,20,0,3,23,0.9999999500000024,0.0
2024-02-29,HD현대마린솔루션,0,1,1,2,0.0,0.9999990000010001
2024-02-29,HD현대미포,10,0,0,10,0.99999990000001,0.0
2024-02-29,HD현대중공업,26,2,4,32,0.9285713954081645,0.07142856887755111
2024-02-29,STX엔진,1,1,0,2,0.499999750000125,0.499999750000125
2024-02-29,삼성중공업,12,3,2,17,0.7999999466666703,0.19999998666666757
2024-02-29,세진중공업,3,1,0,4,0.7499998125000469,0.24999993750001562
2024-02-29,한국카본,2,1,0,3,0.6666664444445185,0.33333322222225925
2024-02-29,한화엔진,6,3,2,11,0.6666665925926009,0.33333329629630043
2024-02-29,한화오션,36,3,2,41,0.9230768994082847,0.0769230749506904
2024-03-01,HD한국조선해양,5,2,1,8,0.7142856122449125,0.285714244897965
2024-03-01,HD현대미포,4,0,0,4,0.9999997500000625,0.0
2024-03-01,HD현대중공업,9,3,1,13,0.7499999375000053,0.2499999791666684
2024-03-01,STX엔진,1,2,0,3,0.33333322222225925,0.6666664444445185
2024-03-01,삼성중공업,3,3,2,8,0.49999991666668053,0.49999991666668053
2024-03-01,세진중공업,1,1,0,2,0.499999750000125,0.499999750000125
2024-03-01,한국카본,1,1,0,2,0.499999750000125,0.499999750000125
2024-03-01,한화엔진,4,2,1,7,0.6666665555555741,0.33333327777778704
2024-03-01,한화오션,8,2,4,14,0.7999999200000081,0.19999998000000202
2024-03-02,HD한국조선해양,4,2,1,7,0.6666665555555741,0.33333327777778704
2024-03-02,HD현대미포,0,1,0,1,0.0,0.9999990000010001
2024-03-02,HD현대중공업,5,1,1,7,0.8333331944444675,0.16666663888889352
2024-03-02,STX엔진,0,1,0,1,0.0,0.9999990000010001
2024-03-02,삼성중공업,2,1,0,3,0.6666664444445185,0.33333322222225925
2024-03-02,한국카본,0,1,0,1,0.0,0.9999990000010001
2024-03-02,한화엔진,1,1,0,2,0.499999750000125,0.499999750000125
2024-03-02,한화오션,6,2,1,9,0.7499999062500118,0.24999996875000394
2024-03-03,HD한국조선해양,5,3,3,11,0.6249999218750099,0.3749999531250059
2024-03-03,HD현대마린솔루션,2,0,0,2,0.99999950000025,0.0
2024-03-03,HD현대미포,1,0,0,1,0.9999990000010001,0.0
2024-03-03,HD현대중공업,8,5,3,16,0.615384568047341,0.3846153550295881
2024-03-03,STX엔진,0,1,0,1,0.0,0.9999990000010001
2024-03-03,삼성중공업,3,3,1,7,0.49999991666668053,0.49999991666668053
2024-03-03,한국카본,0,1,0,1,0.0,0.9999990000010001
2024-03-03,한화엔진,5,2,1,8,0.7142856122449125,0.285714244897965
2024-03-03,한화오션,14,4,3,21,0.7777777345679036,0.2222222098765439
2024-03-04,HD한국조선해양,23,11,3,37,0.676470568339101,0.32352940224913523
2024-03-04,HD현대마린솔루션,3,1,0,4,0.7499998125000469,0.24999993750001562
2024-03-04,HD현대미포,9,1,2,12,0.8999999100000091,0.09999999000000101
2024-03-04,HD현대중공업,42,7,7,56,0.8571428396501461,0.14285713994169102
2024-03-04,STX엔진,4,1,0,5,0.799999840000032,0.199999960000008
2024-03-04,삼성중공업,27,7,3,37,0.7941176237024229,0.20588234688581333
2024-03-04,세진중공업,1,1,0,2,0.499999750000125,0.499999750000125
2024-03-04,한국카본,1,5,4,10,0.16666663888889352,0.8333331944444675
2024-03-04,한화엔진,10,2,0,12,0.8333332638888947,0.16666665277777895
2024-03-04,한화오션,98,25,21,144,0.7967479610020491,0.20325203086786967
2024-03-05,HD한국조선해양,78,29,14,121,0.7289719558040004,0.27102803485020527
2024-03-05,HD현대마린솔루션,3,0,1,4,0.9999996666667778,0.0
2024-03-05,HD현대마린엔진,1,0,0,1,0.9999990000010001,0.0
2024-03-05,HD현대미포,24,5,1,30,0.8275861783590973,0.17241378715814526
2024-03-05,HD현대중공업,115,13,16,144,0.8984374929809571,0.10156249920654298
2024-03-05,STX엔진,4,1,1,6,0.799999840000032,0.199999960000008
2024-03-05,삼성중공업,22,8,8,38,0.7333333088888897,0.26666665777777804
2024-03-05,세진중공업,4,0,1,5,0.9999997500000625,0.0
2024-03-05,한국카본,4,1,1,6,0.799999840000032,0.199999960000008
2024-03-05,한화엔진,14,2,3,19,0.8749999453125034,0.12499999218750048
2024-03-05,한화오션,74,10,27,111,0.8809523704648528,0.1190476176303855
2024-03-06,HD한국조선해양,48,11,5,64,0.8135593082447575,0.18644067480609028
2024-03-06,HD현대마린솔루션,2,0,0,2,0.99999950000025,0.0
2024-03-06,HD현대미포,12,1,1,14,0.9230768520710114,0.07692307100591762
2024-03-06,HD현대중공업,33,5,5,43,0.868421029778394,0.13157894390581729
2024-03-06,STX엔진,1,2,0,3,0.33333322222225925,0.6666664444445185
2024-03-06,삼성중공업,19,9,6,34,0.6785714043367356,0.32142855994898
2024-03-06,세진중공업,1,1,0,2,0.499999750000125,0.499999750000125
2024-03-06,한국카본,1,3,0,4,0.24999993750001562,0.7499998125000469
2024-03-06,한화엔진,10,6,2,18,0.6249999609375024,0.37499997656250145
2024-03-06,한화오션,26,11,9,46,0.7027026837107383,0.2972972892622354
2024-03-07,HD한국조선해양,14,4,4,22,0.7777777345679036,0.2222222098765439
2024-03-07,HD현대마린솔루션,1,0,0,1,0.9999990000010001,0.0
2024-03-07,HD현대미포,5,0,0,5,0.99999980000004,0.0
2024-03-07,HD현대중공업,39,6,5,50,0.8666666474074078,0.13333333037037046
2024-03-07,STX엔진,2,1,0,3,0.6666664444445185,0.33333322222225925
2024-03-07,삼성중공업,19,7,5,31,0.7307692026627229,0.26923075887574005
2024-03-07,세진중공업,1,1,0,2,0.499999750000125,0.499999750000125
2024-03-07,한국카본,1,2,0,3,0.33333322222225925,0.6666664444445185
2024-03-07,한화엔진,13,1,3,17,0.9285713622449028,0.07142856632653098
2024-03-07,한화오션,18,14,5,37,0.5624999824218756,0.4374999863281255
2024-03-08,HD한국조선해양,15,3,2,20,0.8333332870370396,0.1666666574074079
2024-03-08,HD현대마린솔루션,15,5,0,20,0.7499999625000018,0.2499999875000006
2024-03-08,HD현대마린엔진,18,2,0,20,0.8999999550000022,0.09999999500000024
2024-03-08,HD현대미포,10,0,0,10,0.99999990000001,0.0
2024-03-08,HD현대중공업,16,3,2,21,0.8421052188365674,0.15789472853185638
2024-03-08,STX엔진,1,0,0,1,0.9999990000010001,0.0
2024-03-08,삼성중공업,15,4,3,22,0.7894736426592819,0.21052630470914185
2024-03-08,세진중공업,1,0,0,1,0.9999990000010001,0.0
2024-03-08,한국카본,1,0,0,1,0.9999990000010001,0.0
2024-03-08,한화엔진,9,0,1,10,0.9999998888889013,0.0
2024-03-08,한화오션,21,7,4,32,0.7499999732142867,0.24999999107142887
2024-03-09,HD한국조선해양,3,0,1,4,0.9999996666667778,0.0
2024-03-09,HD현대마린솔루션,1,1,0,2,0.499999750000125,0.499999750000125
2024-03-09,HD현대마린엔진,2,0,0,2,0.99999950000025,0.0
2024-03-09,HD현대미포,1,0,0,1,0.9999990000010001,0.0
2024-03-09,HD현대중공업,7,1,0,8,0.8749998906250137,0.12499998437500197
2024-03-09,삼성중공업,5,1,0,6,0.8333331944444675,0.16666663888889352
2024-03-09,한화엔진,7,0,0,7,0.9999998571428775,0.0
2024-03-09,한화오션,9,1,0,10,0.8999999100000091,0.09999999000000101
2024-03-10,HD한국조선해양,9,2,2,13,0.8181817438016598,0.1818181652892577
2024-03-10,HD현대마린솔루션,3,1,0,4,0.7499998125000469,0.24999993750001562
2024-03-10,HD현대마린엔진,2,0,0,2,0.99999950000025,0.0
2024-03-10,HD현대미포,3,2,0,5,0.599999880000024,0.399999920000016
2024-03-10,HD현대중공업,9,2,3,14,0.8181817438016598,0.1818181652892577
2024-03-10,삼성중공업,32,2,0,34,0.9411764429065753,0.05882352768166096
2024-03-10,한국카본,2,0,0,2,0.99999950000025,0.0
2024-03-10,한화엔진,9,1,0,10,0.8999999100000091,0.09999999000000101
2024-03-10,한화오션,10,3,3,16,0.7692307100591762,0.23076921301775286
2024-03-11,HD한국조선해양,55,5,3,63,0.9166666513888891,0.08333333194444448
2024-03-11,HD현대마린솔루션,53,4,0,57,0.9298245450907975,0.07017543736534321
2024-03-11,HD현대마린엔진,35,1,0,36,0.9722221952160502,0.027777777006172864
2024-03-11,HD현대미포,5,2,2,9,0.7142856122449125,0.285714244897965
2024-03-11,HD현대중공업,16,4,4,24,0.799999960000002,0.1999999900000005
2024-03-11,STX엔진,0,1,0,1,0.0,0.9999990000010001
2024-03-11,삼성중공업,29,10,4,43,0.7435897245233405,0.25641024983563465
2024-03-11,세진중공업,2,7,1,10,0.22222219753086697,0.7777776913580343
2024-03-11,한국카본,0,3,0,3,0.0,0.9999996666667778
2024-03-11,한화엔진,13,1,1,15,0.9285713622449028,0.07142856632653098
2024-03-11,한화오션,16,11,15,42,0.5925925706447196,0.4074073923182447
2024-03-12,HD한국조선해양,18,4,3,25,0.8181817809917372,0.18181817355371938
2024-03-12,HD현대마린솔루션,8,2,0,10,0.7999999200000081,0.19999998000000202
2024-03-12,HD현대마린엔진,7,0,0,7,0.9999998571428775,0.0
2024-03-12,HD현대미포,1,3,0,4,0.24999993750001562,0.7499998125000469
2024-03-12,HD현대중공업,21,4,3,28,0.8399999664000013,0.15999999360000025
2024-03-12,STX엔진,0,2,0,2,0.0,0.99999950000025
2024-03-12,삼성중공업,17,7,5,29,0.7083333038194456,0.2916666545138894
2024-03-12,세진중공업,1,0,0,1,0.9999990000010001,0.0
2024-03-12,한국카본,10,0,0,10,0.99999990000001,0.0
2024-03-12,한화엔진,17,2,1,20,0.8947367950138528,0.10526315235457093
2024-03-12,한화오션,25,9,6,40,0.7352940960207619,0.2647058745674743
2024-03-13,HD한국조선해양,18,8,1,27,0.6923076656804744,0.30769229585798863
2024-03-13,HD현대마린솔루션,1,2,0,3,0.33333322222225925,0.6666664444445185
2024-03-13,HD현대마린엔진,0,1,0,1,0.0,0.9999990000010001
2024-03-13,HD현대미포,3,0,0,3,0.9999996666667778,0.0
2024-03-13,HD현대중공업,50,6,3,59,0.8928571269132657,0.10714285522959188
2024-03-13,STX엔진,2,0,0,2,0.99999950000025,0.0
2024-03-13,삼성중공업,18,10,4,32,0.64285711989796,0.35714284438775556
2024-03-13,세진중공업,1,0,0,1,0.9999990000010001,0.0
2024-03-13,한국카본,2,0,0,2,0.99999950000025,0.0
2024-03-13,한화엔진,18,5,0,23,0.7826086616257103,0.21739129489603065
2024-03-13,한화오션,28,12,8,48,0.6999999825000005,0.2999999925000002
2024-03-14,HD한국조선해양,19,23,4,46,0.4523809416099776,0.5476190345804992
2024-03-14,HD현대마린솔루션,2,2,1,5,0.49999987500003124,0.49999987500003124
2024-03-14,HD현대마린엔진,1,0,0,1,0.9999990000010001,0.0
2024-03-14,HD현대미포,5,9,0,14,0.3571428316326549,0.6428570969387788
2024-03-14,HD현대중공업,22,25,3,50,0.46808509642372137,0.5319148822996834
2024-03-14,STX엔진,0,3,0,3,0.0,0.9999996666667778
2024-03-14,삼성중공업,28,35,9,72,0.44444443738977085,0.5555555467372135
2024-03-14,세진중공업,3,4,0,7,0.4285713673469475,0.57142848979593
2024-03-14,한국카본,1,4,0,5,0.199999960000008,0.799999840000032
2024-03-14,한화엔진,14,9,2,25,0.6086956257088858,0.39130433081285515
2024-03-14,한화오션,30,34,6,70,0.4687499926757814,0.5312499916992189
2024-03-15,HD한국조선해양,13,17,4,34,0.4333333188888894,0.5666666477777784
2024-03-15,HD현대마린솔루션,4,1,0,5,0.799999840000032,0.199999960000008
2024-03-15,HD현대마린엔진,0,1,0,1,0.0,0.9999990000010001
2024-03-15,HD현대미포,8,10,2,20,0.4444444197530878,0.5555555246913597
2024-03-15,HD현대중공업,15,8,3,26,0.6521738846880919,0.34782607183364905
2024-03-15,STX엔진,1,2,1,4,0.33333322222225925,0.6666664444445185
2024-03-15,삼성중공업,20,15,4,39,0.5714285551020413,0.428571416326531
2024-03-15,세진중공업,1,3,0,4,0.24999993750001562,0.7499998125000469
2024-03-15,한국카본,3,2,0,5,0.599999880000024,0.399999920000016
2024-03-15,한화엔진,13,8,1,22,0.6190475895691624,0.38095236281179223
2024-03-15,한화오션,17,19,2,38,0.4722222091049387,0.5277777631172844
2024-03-16,HD한국조선해양,3,4,1,8,0.4285713673469475,0.57142848979593
2024-03-16,HD현대마린솔루션,1,0,0,1,0.9999990000010001,0.0
2024-03-16,HD현대마린엔진,1,0,0,1,0.9999990000010001,0.0
2024-03-16,HD현대미포,2,2,0,4,0.49999987500003124,0.49999987500003124
2024-03-16,HD현대중공업,5,2,1,8,0.7142856122449125,0.285714244897965
2024-03-16,삼성중공업,5,3,2,10,0.6249999218750099,0.3749999531250059
2024-03-16,세진중공업,1,0,0,1,0.9999990000010001,0.0
2024-03-16,한화오션,3,4,2,9,0.4285713673469475,0.57142848979593
2024-03-17,HD한국조선해양,4,5,2,11,0.44444439506173394,0.5555554938271674
2024-03-17,HD현대마린솔루션,0,1,0,1,0.0,0.9999990000010001
2024-03-17,HD현대미포,1,3,0,4,0.24999993750001562,0.7499998125000469
2024-03-17,HD현대중공업,9,2,2,13,0.8181817438016598,0.1818181652892577
2024-03-17,STX엔진,0,1,0,1,0.0,0.9999990000010001
2024-03-17,삼성중공업,4,5,5,14,0.44444439506173394,0.5555554938271674
2024-03-17,세진중공업,0,1,0,1,0.0,0.9999990000010001
2024-03-17,한국카본,0,1,0,1,0.0,0.9999990000010001
2024-03-17,한화엔진,1,2,1,4,0.33333322222225925,0.6666664444445185
2024-03-17,한화오션,3,9,3,15,0.2499999791666684,0.7499999375000053
2024-03-18,HD한국조선해양,9,13,2,24,0.4090908904958686,0.590909064049588
2024-03-18,HD현대마린솔루션,2,0,0,2,0.99999950000025,0.0
2024-03-18,HD현대미포,7,5,1,13,0.5833332847222263,0.41666663194444736
2024-03-18,HD현대중공업,19,24,4,47,0.44186045484045455,0.5581395219037321
2024-03-18,STX엔진,1,6,0,7,0.1428571224489825,0.857142734693895
2024-03-18,삼성중공업,17,15,2,34,0.5312499833984381,0.468749985351563
2024-03-18,세진중공업,1,5,0,6,0.16666663888889352,0.8333331944444675
2024-03-18,한국카본,1,1,0,2,0.499999750000125,0.499999750000125
2024-03-18,한화엔진,14,5,1,20,0.7368420664819965,0.26315788088642733
2024-03-18,한화오션,17,35,5,57,0.3269230706360948,0.6730769101331364
2024-03-19,HD한국조선해양,20,11,3,34,0.6451612695109268,0.3548386982310097
2024-03-19,HD현대마린솔루션,4,0,1,5,0.9999997500000625,0.0
2024-03-19,HD현대미포,15,4,1,20,0.7894736426592819,0.21052630470914185
2024-03-19,HD현대중공업,27,6,2,35,0.8181817933884306,0.18181817630854014
2024-03-19,삼성중공업,26,6,7,39,0.8124999746093758,0.1874999941406252
2024-03-19,세진중공업,0,2,0,2,0.0,0.99999950000025
2024-03-19,한국카본,9,4,0,13,0.6923076390532585,0.3076922840236705
2024-03-19,한화엔진,14,4,1,19,0.7777777345679036,0.2222222098765439
2024-03-19,한화오션,53,16,7,76,0.7681159308968706,0.23188405461037603
2024-03-20,HD한국조선해양,19,10,3,32,0.655172391200952,0.3448275743162905
2024-03-20,HD현대마린솔루션,4,0,2,6,0.9999997500000625,0.0
2024-03-20,HD현대마린엔진,2,0,0,2,0.99999950000025,0.0
2024-03-20,HD현대미포,11,2,1,14,0.8461537810650938,0.15384614201183525
2024-03-20,HD현대중공업,20,10,5,35,0.6666666444444451,0.33333332222222256
2024-03-20,STX엔진,1,2,0,3,0.33333322222225925,0.6666664444445185
2024-03-20,삼성중공업,21,12,5,38,0.6363636170798904,0.36363635261708027
2024-03-20,세진중공업,2,2,0,4,0.49999987500003124,0.49999987500003124
2024-03-20,한국카본,3,2,0,5,0.599999880000024,0.399999920000016
2024-03-20,한화엔진,17,3,0,20,0.8499999575000021,0.14999999250000037
2024-03-20,한화오션,25,13,4,42,0.6578947195290864,0.34210525415512494
2024-03-21,HD한국조선해양,15,2,2,19,0.8823528892733594,0.11764705190311459
2024-03-21,HD현대마린솔루션,4,2,0,6,0.6666665555555741,0.33333327777778704
2024-03-21,HD현대마린엔진,1,0,0,1,0.9999990000010001,0.0
2024-03-21,HD현대미포,2,1,0,3,0.6666664444445185,0.33333322222225925
2024-03-21,HD현대중공업,36,3,2,41,0.9230768994082847,0.0769230749506904
2024-03-21,STX엔진,1,2,1,4,0.33333322222225925,0.6666664444445185
2024-03-21,삼성중공업,23,2,4,29,0.9199999632000014,0.07999999680000013
2024-03-21,세진중공업,0,1,0,1,0.0,0.9999990000010001
2024-03-21,한국카본,0,1,0,1,0.0,0.9999990000010001
2024-03-21,한화엔진,15,4,2,21,0.7894736426592819,0.21052630470914185
2024-03-21,한화오션,23,5,2,30,0.8214285420918378,0.17857142219387778
2024-03-22,HD한국조선해양,12,4,4,20,0.7499999531250029,0.24999998437500096
2024-03-22,HD현대마린솔루션,4,3,1,8,0.57142848979593,0.4285713673469475
2024-03-22,HD현대마린엔진,1,0,0,1,0.9999990000010001,0.0
2024-03-22,HD현대미포,2,1,1,4,0.6666664444445185,0.33333322222225925
2024-03-22,HD현대중공업,18,3,1,22,0.8571428163265326,0.14285713605442207
2024-03-22,STX엔진,1,1,1,3,0.499999750000125,0.499999750000125
2024-03-22,삼성중공업,12,9,5,26,0.5714285442176883,0.4285714081632663
2024-03-22,세진중공업,1,0,0,1,0.9999990000010001,0.0
2024-03-22,한국카본,2,0,0,2,0.99999950000025,0.0
2024-03-22,한화엔진,13,3,1,17,0.8124999492187531,0.18749998828125072
2024-03-22,한화오션,11,8,4,23,0.5789473379501401,0.4210526094182837
2024-03-23,HD한국조선해양,3,2,0,5,0.599999880000024,0.399999920000016
2024-03-23,HD현대미포,1,1,0,2,0.499999750000125,0.499999750000125
2024-03-23,HD현대중공업,4,1,0,5,0.799999840000032,0.199999960000008
2024-03-23,STX엔진,0,1,0,1,0.0,0.9999990000010001
2024-03-23,삼성중공업,6,2,1,9,0.7499999062500118,0.24999996875000394
2024-03-23,한화엔진,2,2,0,4,0.49999987500003124,0.49999987500003124
2024-03-23,한화오션,7,2,1,10,0.7777776913580343,0.22222219753086697
2024-03-24,HD한국조선해양,5,5,0,10,0.499999950000005,0.499999950000005
2024-03-24,HD현대마린솔루션,0,1,0,1,0.0,0.9999990000010001
2024-03-24,HD현대미포,1,0,0,1,0.9999990000010001,0.0
2024-03-24,HD현대중공업,16,1,1,18,0.9411764152249167,0.05882352595155729
2024-03-24,STX엔진,0,1,0,1,0.0,0.9999990000010001
2024-03-24,삼성중공업,12,1,1,14,0.9230768520710114,0.07692307100591762
2024-03-24,세진중공업,0,0,1,1,0.0,0.0
2024-03-24,한국카본,0,1,0,1,0.0,0.9999990000010001
2024-03-24,한화엔진,4,1,0,5,0.799999840000032,0.199999960000008
2024-03-24,한화오션,18,5,4,27,0.7826086616257103,0.21739129489603065
2024-03-25,HD한국조선해양,29,8,0,37,0.7837837626004389,0.21621621037253486
2024-03-25,HD현대마린솔루션,9,1,0,10,0.8999999100000091,0.09999999000000101
2024-03-25,HD현대마린엔진,1,0,0,1,0.9999990000010001,0.0
2024-03-25,HD현대미포,13,4,1,18,0.7647058373702448,0.23529410380622917
2024-03-25,HD현대중공업,24,8,0,32,0.7499999765625008,0.24999999218750027
2024-03-25,STX엔진,1,0,0,1,0.9999990000010001,0.0
2024-03-25,삼성중공업,116,8,11,135,0.9354838634235173,0.06451612851196671
2024-03-25,세진중공업,1,2,0,3,0.33333322222225925,0.6666664444445185
2024-03-25,한국카본,1,0,0,1,0.9999990000010001,0.0
2024-03-25,한화엔진,3,4,0,7,0.4285713673469475,0.57142848979593
2024-03-25,한화오션,49,14,2,65,0.777777765432099,0.22222221869488543
2024-03-26,HD한국조선해양,18,7,1,26,0.7199999712000011,0.27999998880000043
2024-03-26,HD현대마린솔루션,15,3,2,20,0.8333332870370396,0.1666666574074079
2024-03-26,HD현대마린엔진,8,0,0,8,0.9999998750000157,0.0
2024-03-26,HD현대미포,12,3,0,15,0.7999999466666703,0.19999998666666757
2024-03-26,HD현대중공업,26,8,2,36,0.7647058598615925,0.23529411072664383
2024-03-26,STX엔진,1,1,0,2,0.499999750000125,0.499999750000125
2024-03-26,삼성중공업,25,4,2,31,0.8620689357907263,0.13793102972651622
2024-03-26,세진중공업,1,1,0,2,0.499999750000125,0.499999750000125
2024-03-26,한국카본,1,2,0,3,0.33333322222225925,0.6666664444445185
2024-03-26,한화엔진,19,2,2,23,0.9047618616780065,0.09523809070294806
2024-03-26,한화오션,83,11,4,98,0.8829787140108648,0.1170212753508375
2024-03-27,HD한국조선해양,17,7,5,29,0.7083333038194456,0.2916666545138894
2024-03-27,HD현대마린솔루션,8,4,1,13,0.6666666111111158,0.3333333055555579
2024-03-27,HD현대마린엔진,8,1,0,9,0.8888887901234679,0.11111109876543349
2024-03-27,HD현대미포,22,1,2,25,0.9565216975425348,0.04347825897920613
2024-03-27,HD현대중공업,37,10,5,52,0.7872340258035314,0.21276595291987335
2024-03-27,STX엔진,1,1,0,2,0.499999750000125,0.499999750000125
2024-03-27,삼성중공업,12,10,12,34,0.5454545206611581,0.4545454338842984
2024-03-27,세진중공업,1,1,0,2,0.499999750000125,0.499999750000125
2024-03-27,한국카본,4,1,5,10,0.799999840000032,0.199999960000008
2024-03-27,한화엔진,16,4,1,21,0.799999960000002,0.1999999900000005
2024-03-27,한화오션,29,16,12,57,0.6444444301234571,0.3555555476543212
2024-03-28,HD한국조선해양,12,2,4,18,0.8571427959183717,0.14285713265306196
2024-03-28,HD현대마린솔루션,4,3,0,7,0.57142848979593,0.4285713673469475
2024-03-28,HD현대마린엔진,2,1,0,3,0.6666664444445185,0.33333322222225925
2024-03-28,HD현대미포,10,1,1,12,0.9090908264462886,0.09090908264462885
2024-03-28,HD현대중공업,23,4,4,31,0.8518518203017844,0.1481481426611799
2024-03-28,STX엔진,0,1,0,1,0.0,0.9999990000010001
2024-03-28,삼성중공업,20,4,8,32,0.8333332986111125,0.1666666597222225
2024-03-28,세진중공업,1,0,0,1,0.9999990000010001,0.0
2024-03-28,한화엔진,10,3,1,14,0.7692307100591762,0.23076921301775286
2024-03-28,한화오션,30,6,7,43,0.8333333101851859,0.16666666203703717
2024-03-29,HD한국조선해양,14,8,1,23,0.6363636074380178,0.36363634710743875
2024-03-29,HD현대마린솔루션,5,2,3,10,0.7142856122449125,0.285714244897965
2024-03-29,HD현대마린엔진,2,0,0,2,0.99999950000025,0.0
2024-03-29,HD현대미포,9,1,0,10,0.8999999100000091,0.09999999000000101
2024-03-29,HD현대중공업,73,8,4,85,0.9012345567748821,0.09876543087943913
2024-03-29,STX엔진,1,2,0,3,0.33333322222225925,0.6666664444445185
2024-03-29,삼성중공업,16,3,1,20,0.8421052188365674,0.15789472853185638
2024-03-29,세진중공업,1,1,0,2,0.499999750000125,0.499999750000125
2024-03-29,한국카본,2,0,0,2,0.99999950000025,0.0
2024-03-29,한화엔진,7,4,0,11,0.636363578512402,0.3636363305785154
2024-03-29,한화오션,22,7,2,31,0.7586206634958391,0.24137930202140337
2024-03-30,HD한국조선해양,5,1,0,6,0.8333331944444675,0.16666663888889352
2024-03-30,HD현대마린솔루션,1,1,0,2,0.499999750000125,0.499999750000125
2024-03-30,HD현대마린엔진,1,0,0,1,0.9999990000010001,0.0
2024-03-30,HD현대미포,1,0,0,1,0.9999990000010001,0.0
2024-03-30,HD현대중공업,5,2,1,8,0.7142856122449125,0.285714244897965
2024-03-30,삼성중공업,4,1,0,5,0.799999840000032,0.199999960000008
2024-03-30,한화엔진,3,1,0,4,0.7499998125000469,0.24999993750001562
2024-03-30,한화오션,9,1,0,10,0.8999999100000091,0.09999999000000101
2024-03-31,HD한국조선해양,5,2,1,8,0.7142856122449125,0.285714244897965
2024-03-31,HD현대마린솔루션,2,1,0,3,0.6666664444445185,0.33333322222225925
2024-03-31,HD현대미포,4,1,0,5,0.799999840000032,0.199999960000008
2024-03-31,HD현대중공업,16,3,0,19,0.8421052188365674,0.15789472853185638
2024-03-31,STX엔진,1,0,1,2,0.9999990000010001,0.0
2024-03-31,삼성중공업,4,2,0,6,0.6666665555555741,0.33333327777778704
2024-03-31,한국카본,1,0,0,1,0.9999990000010001,0.0
2024-03-31,한화엔진,6,1,1,8,0.857142734693895,0.1428571224489825
2024-03-31,한화오션,9,3,6,18,0.7499999375000053,0.2499999791666684
2024-04-01,HD한국조선해양,14,4,3,21,0.7777777345679036,0.2222222098765439
2024-04-01,HD현대마린솔루션,11,6,1,18,0.6470587854671302,0.35294115570934376
2024-04-01,HD현대마린엔진,3,0,0,3,0.9999996666667778,0.0
2024-04-01,HD현대미포,13,0,3,16,0.9999999230769291,0.0
2024-04-01,HD현대중공업,18,7,4,29,0.7199999712000011,0.27999998880000043
2024-04-01,STX엔진,7,0,0,7,0.9999998571428775,0.0
2024-04-01,삼성중공업,15,3,4,22,0.8333332870370396,0.1666666574074079
2024-04-01,세진중공업,7,2,0,9,0.7777776913580343,0.22222219753086697
2024-04-01,한국카본,3,0,1,4,0.9999996666667778,0.0
2024-04-01,한화엔진,14,0,2,16,0.9999999285714337,0.0
2024-04-01,한화오션,52,5,6,63,0.9122806857494616,0.08771929670667901
2024-04-02,HD한국조선해양,10,9,0,19,0.5263157617728547,0.47368418559556913
2024-04-02,HD현대마린솔루션,7,6,5,18,0.5384614970414233,0.4615384260355057
2024-04-02,HD현대마린엔진,1,0,0,1,0.9999990000010001,0.0
2024-04-02,HD현대미포,7,2,1,10,0.7777776913580343,0.22222219753086697
2024-04-02,HD현대중공업,26,7,2,35,0.7878787640036738,0.21212120569329682
2024-04-02,STX엔진,4,4,0,8,0.4999999375000079,0.4999999375000079
2024-04-02,삼성중공업,15,4,4,23,0.7894736426592819,0.21052630470914185
2024-04-02,세진중공업,6,4,0,10,0.599999940000006,0.39999996000000404
2024-04-02,한국카본,3,3,0,6,0.49999991666668053,0.49999991666668053
2024-04-02,한화엔진,8,5,0,13,0.615384568047341,0.3846153550295881
2024-04-02,한화오션,33,9,4,46,0.7857142670068032,0.2142857091836736
2024-04-03,HD한국조선해양,19,13,2,34,0.5937499814453131,0.4062499873046879
2024-04-03,HD현대마린솔루션,6,8,2,16,0.42857139795918586,0.5714285306122479
2024-04-03,HD현대마린엔진,10,2,1,13,0.8333332638888947,0.16666665277777895
2024-04-03,HD현대미포,13,8,0,21,0.6190475895691624,0.38095236281179223
2024-04-03,HD현대중공업,44,23,4,71,0.6567164081087103,0.34328357696591677
2024-04-03,STX엔진,1,1,1,3,0.499999750000125,0.499999750000125
2024-04-03,삼성중공업,26,25,2,53,0.5098039115724724,0.49019606881968497
2024-04-03,세진중공업,3,3,1,7,0.49999991666668053,0.49999991666668053
2024-04-03,한국카본,8,4,1,13,0.6666666111111158,0.3333333055555579
2024-04-03,한화엔진,20,3,1,24,0.8695651795841226,0.1304347769376184
2024-04-03,한화오션,103,40,7,150,0.7202797152427992,0.2797202777641939
2024-04-04,HD한국조선해양,9,5,0,14,0.6428570969387788,0.3571428316326549
2024-04-04,HD현대마린솔루션,5,3,2,10,0.6249999218750099,0.3749999531250059
2024-04-04,HD현대마린엔진,4,3,0,7,0.57142848979593,0.4285713673469475
2024-04-04,HD현대미포,4,3,0,7,0.57142848979593,0.4285713673469475
2024-04-04,HD현대중공업,59,18,1,78,0.7662337562826785,0.2337662307303087
2024-04-04,STX엔진,2,0,0,2,0.99999950000025,0.0
2024-04-04,삼성중공업,20,5,1,26,0.7999999680000013,0.19999999200000032
2024-04-04,세진중공업,2,0,0,2,0.99999950000025,0.0
2024-04-04,한국카본,1,0,0,1,0.9999990000010001,0.0
2024-04-04,한화엔진,9,1,0,10,0.8999999100000091,0.09999999000000101
2024-04-04,한화오션,62,26,9,97,0.7045454465392563,0.2954545420971075
2024-04-05,HD한국조선해양,5,8,2,15,0.3846153550295881,0.615384568047341
2024-04-05,HD현대마린솔루션,4,4,1,9,0.4999999375000079,0.4999999375000079
2024-04-05,HD현대마린엔진,0,1,0,1,0.0,0.9999990000010001
2024-04-05,HD현대미포,3,3,0,6,0.49999991666668053,0.49999991666668053
2024-04-05,HD현대중공업,22,8,3,33,0.7333333088888897,0.26666665777777804
2024-04-05,STX엔진,1,0,1,2,0.9999990000010001,0.0
2024-04-05,삼성중공업,7,6,0,13,0.5384614970414233,0.4615384260355057
2024-04-05,세진중공업,0,2,1,3,0.0,0.99999950000025
2024-04-05,한화엔진,8,1,1,10,0.8888887901234679,0.11111109876543349
2024-04-05,한화오션,113,17,4,134,0.8692307625443788,0.13076922976331362
2024-04-06,HD한국조선해양,5,3,0,8,0.6249999218750099,0.3749999531250059
2024-04-06,HD현대미포,1,1,0,2,0.499999750000125,0.499999750000125
2024-04-06,HD현대중공업,8,3,0,11,0.7272726611570308,0.2727272479338866
2024-04-06,STX엔진,1,0,0,1,0.9999990000010001,0.0
2024-04-06,삼성중공업,4,2,2,8,0.6666665555555741,0.33333327777778704
2024-04-06,세진중공업,1,0,0,1,0.9999990000010001,0.0
2024-04-06,한국카본,1,0,0,1,0.9999990000010001,0.0
2024-04-06,한화엔진,4,0,0,4,0.9999997500000625,0.0
2024-04-06,한화오션,12,5,1,18,0.7058823114186875,0.2941176297577865
2024-04-07,HD한국조선해양,8,9,0,17,0.47058820761245834,0.5294117335640156
2024-04-07,HD현대마린솔루션,2,1,0,3,0.6666664444445185,0.33333322222225925
2024-04-07,HD현대미포,13,1,0,14,0.9285713622449028,0.07142856632653098
2024-04-07,HD현대중공업,17,2,0,19,0.8947367950138528,0.10526315235457093
2024-04-07,STX엔진,0,1,0,1,0.0,0.9999990000010001
2024-04-07,삼성중공업,3,3,0,6,0.49999991666668053,0.49999991666668053
2024-04-07,한국카본,0,1,1,2,0.0,0.9999990000010001
2024-04-07,한화엔진,6,2,0,8,0.7499999062500118,0.24999996875000394
2024-04-07,한화오션,17,10,1,28,0.6296296063100145,0.37037035665294976
2024-04-08,HD한국조선해양,16,8,3,27,0.66666663888889,0.333333319444445
2024-04-08,HD현대마린솔루션,6,2,0,8,0.7499999062500118,0.24999996875000394
2024-04-08,HD현대마린엔진,1,0,0,1,0.9999990000010001,0.0
2024-04-08,HD현대미포,13,1,2,16,0.9285713622449028,0.07142856632653098
2024-04-08,HD현대중공업,20,10,2,32,0.6666666444444451,0.33333332222222256
2024-04-08,STX엔진,2,0,0,2,0.99999950000025,0.0
2024-04-08,삼성중공업,19,11,4,34,0.6333333122222229,0.36666665444444485
2024-04-08,세진중공업,3,0,0,3,0.9999996666667778,0.0
2024-04-08,한국카본,2,0,1,3,0.99999950000025,0.0
2024-04-08,한화엔진,15,2,1,18,0.8823528892733594,0.11764705190311459
2024-04-08,한화오션,36,11,6,53,0.7659574305115441,0.23404254821186068
2024-04-09,HD한국조선해양,13,8,0,21,0.6190475895691624,0.38095236281179223
2024-04-09,HD현대마린솔루션,3,0,0,3,0.9999996666667778,0.0
2024-04-09,HD현대미포,4,1,1,6,0.799999840000032,0.199999960000008
2024-04-09,HD현대중공업,17,2,2,21,0.8947367950138528,0.10526315235457093
2024-04-09,STX엔진,0,2,0,2,0.0,0.99999950000025
2024-04-09,삼성중공업,23,9,4,36,0.7187499775390632,0.2812499912109378
2024-04-09,세진중공업,0,2,0,2,0.0,0.99999950000025
2024-04-09,한국카본,1,1,0,2,0.499999750000125,0.499999750000125
2024-04-09,한화엔진,8,3,1,12,0.7272726611570308,0.2727272479338866
2024-04-09,한화오션,28,8,4,40,0.7777777561728402,0.22222221604938291
2024-04-10,HD한국조선해양,7,3,0,10,0.699999930000007,0.299999970000003
2024-04-10,HD현대마린솔루션,3,3,1,7,0.49999991666668053,0.49999991666668053
2024-04-10,HD현대마린엔진,1,0,0,1,0.9999990000010001,0.0
2024-04-10,HD현대미포,1,1,0,2,0.499999750000125,0.499999750000125
2024-04-10,HD현대중공업,6,4,0,10,0.599999940000006,0.39999996000000404
2024-04-10,삼성중공업,7,3,2,12,0.699999930000007,0.299999970000003
2024-04-10,세진중공업,2,1,0,3,0.6666664444445185,0.33333322222225925
2024-04-10,한화엔진,5,0,0,5,0.99999980000004,0.0
2024-04-10,한화오션,8,5,2,15,0.615384568047341,0.3846153550295881
2024-04-11,HD한국조선해양,13,7,1,21,0.6499999675000016,0.34999998250000086
2024-04-11,HD현대마린솔루션,9,1,0,10,0.8999999100000091,0.09999999000000101
2024-04-11,HD현대마린엔진,7,0,1,8,0.9999998571428775,0.0
2024-04-11,HD현대미포,9,3,0,12,0.7499999375000053,0.2499999791666684
2024-04-11,HD현대중공업,39,6,3,48,0.8666666474074078,0.13333333037037046
2024-04-11,삼성중공업,7,9,2,18,0.4374999726562517,0.5624999648437522
2024-04-11,한국카본,2,0,0,2,0.99999950000025,0.0
2024-04-11,한화엔진,8,1,2,11,0.8888887901234679,0.11111109876543349
2024-04-11,한화오션,18,12,1,31,0.5999999800000007,0.3999999866666671
2024-04-12,HD한국조선해양,9,2,2,13,0.8181817438016598,0.1818181652892577
2024-04-12,HD현대마린솔루션,4,0,0,4,0.9999997500000625,0.0
2024-04-12,HD현대마린엔진,2,0,0,2,0.99999950000025,0.0
2024-04-12,HD현대미포,2,0,1,3,0.99999950000025,0.0
2024-04-12,HD현대중공업,8,7,4,19,0.5333332977777802,0.46666663555555765
2024-04-12,삼성중공업,7,2,5,14,0.7777776913580343,0.22222219753086697
2024-04-12,한화엔진,9,1,2,12,0.8999999100000091,0.09999999000000101
2024-04-12,한화오션,19,9,6,34,0.6785714043367356,0.32142855994898
2024-04-13,HD한국조선해양,3,1,0,4,0.7499998125000469,0.24999993750001562
2024-04-13,HD현대마린솔루션,1,4,0,5,0.199999960000008,0.799999840000032
2024-04-13,HD현대마린엔진,3,2,0,5,0.599999880000024,0.399999920000016
2024-04-13,HD현대미포,1,1,0,2,0.499999750000125,0.499999750000125
2024-04-13,HD현대중공업,6,4,0,10,0.599999940000006,0.39999996000000404
2024-04-13,STX엔진,0,1,0,1,0.0,0.9999990000010001
2024-04-13,삼성중공업,5,3,0,8,0.6249999218750099,0.3749999531250059
2024-04-13,한화엔진,2,1,1,4,0.6666664444445185,0.33333322222225925
2024-04-13,한화오션,7,2,1,10,0.7777776913580343,0.22222219753086697
2024-04-14,HD한국조선해양,8,3,0,11,0.7272726611570308,0.2727272479338866
2024-04-14,HD현대마린솔루션,6,3,1,10,0.6666665925926009,0.33333329629630043
2024-04-14,HD현대마린엔진,2,0,1,3,0.99999950000025,0.0
2024-04-14,HD현대미포,0,2,0,2,0.0,0.99999950000025
2024-04-14,HD현대중공업,12,3,0,15,0.7999999466666703,0.19999998666666757
2024-04-14,STX엔진,1,1,0,2,0.499999750000125,0.499999750000125
2024-04-14,삼성중공업,6,3,0,9,0.6666665925926009,0.33333329629630043
2024-04-14,세진중공업,0,1,0,1,0.0,0.9999990000010001
2024-04-14,한국카본,1,1,0,2,0.499999750000125,0.499999750000125
2024-04-14,한화엔진,0,3,0,3,0.0,0.9999996666667778
2024-04-14,한화오션,5,4,1,10,0.5555554938271674,0.44444439506173394
2024-04-15,HD한국조선해양,19,6,2,27,0.7599999696000012,0.23999999040000036
2024-04-15,HD현대마린솔루션,33,2,3,38,0.9428571159183682,0.057142855510204135
2024-04-15,HD현대마린엔진,10,2,0,12,0.8333332638888947,0.16666665277777895
2024-04-15,HD현대미포,10,2,1,13,0.8333332638888947,0.16666665277777895
2024-04-15,HD현대중공업,22,5,3,30,0.8148147846364894,0.18518517832647488
2024-04-15,STX엔진,12,2,1,15,0.8571427959183717,0.14285713265306196
2024-04-15,삼성중공업,20,7,3,30,0.7407407133058995,0.2592592496570648
2024-04-15,세진중공업,1,1,1,3,0.499999750000125,0.499999750000125
2024-04-15,한국카본,5,5,0,10,0.499999950000005,0.499999950000005
2024-04-15,한화엔진,23,2,1,26,0.9199999632000014,0.07999999680000013
2024-04-15,한화오션,33,11,7,51,0.7499999829545458,0.24999999431818196
2024-04-16,HD한국조선해양,18,4,5,27,0.8181817809917372,0.18181817355371938
2024-04-16,HD현대마린솔루션,10,2,2,14,0.8333332638888947,0.16666665277777895
2024-04-16,HD현대마린엔진,5,1,1,7,0.8333331944444675,0.16666663888889352
2024-04-16,HD현대미포,8,1,0,9,0.8888887901234679,0.11111109876543349
2024-04-16,HD현대중공업,22,2,2,26,0.9166666284722238,0.08333332986111125
2024-04-16,STX엔진,3,2,1,6,0.599999880000024,0.399999920000016
2024-04-16,삼성중공업,12,6,5,23,0.6666666296296316,0.3333333148148158
2024-04-16,세진중공업,1,0,0,1,0.9999990000010001,0.0
2024-04-16,한국카본,2,1,0,3,0.6666664444445185,0.33333322222225925
2024-04-16,한화엔진,19,6,4,29,0.7599999696000012,0.23999999040000036
2024-04-16,한화오션,28,9,5,42,0.7567567363038721,0.24324323666910172
2024-04-17,HD한국조선해양,13,6,4,23,0.684210490304711,0.31578945706371275
2024-04-17,HD현대마린솔루션,6,0,1,7,0.9999998333333611,0.0
2024-04-17,HD현대마린엔진,1,0,0,1,0.9999990000010001,0.0
2024-04-17,HD현대미포,9,3,3,15,0.7499999375000053,0.2499999791666684
2024-04-17,HD현대중공업,159,15,8,182,0.9137930981965914,0.0862068960562822
2024-04-17,STX엔진,1,0,0,1,0.9999990000010001,0.0
2024-04-17,삼성중공업,13,3,6,22,0.8124999492187531,0.18749998828125072
2024-04-17,세진중공업,1,0,0,1,0.9999990000010001,0.0
2024-04-17,한국카본,0,1,0,1,0.0,0.9999990000010001
2024-04-17,한화엔진,12,2,0,14,0.8571427959183717,0.14285713265306196
2024-04-17,한화오션,21,5,6,32,0.8076922766272201,0.1923076849112429
2024-04-18,HD한국조선해양,26,10,4,40,0.7222222021604945,0.2777777700617286
2024-04-18,HD현대마린솔루션,15,2,2,19,0.8823528892733594,0.11764705190311459
2024-04-18,HD현대마린엔진,1,0,0,1,0.9999990000010001,0.0
2024-04-18,HD현대미포,8,17,3,28,0.3199999872000005,0.679999972800001
2024-04-18,HD현대중공업,33,29,5,67,0.5322580559313217,0.46774192793964636
2024-04-18,STX엔진,4,0,0,4,0.9999997500000625,0.0
2024-04-18,삼성중공업,33,30,10,73,0.523809515495087,0.47619046863189735
2024-04-18,세진중공업,0,4,0,4,0.0,0.9999997500000625
2024-04-18,한국카본,4,3,0,7,0.57142848979593,0.4285713673469475
2024-04-18,한화엔진,10,5,0,15,0.6666666222222252,0.3333333111111126
2024-04-18,한화오션,27,29,5,61,0.4821428485331634,0.5178571336096941
2024-04-19,HD한국조선해양,16,8,4,28,0.66666663888889,0.333333319444445
2024-04-19,HD현대마린솔루션,5,3,2,10,0.6249999218750099,0.3749999531250059
2024-04-19,HD현대마린엔진,0,1,0,1,0.0,0.9999990000010001
2024-04-19,HD현대미포,9,6,7,22,0.5999999600000027,0.39999997333333515
2024-04-19,HD현대중공업,22,13,7,42,0.6285714106122454,0.37142856081632686
2024-04-19,STX엔진,0,1,1,2,0.0,0.9999990000010001
2024-04-19,삼성중공업,15,11,10,36,0.5769230547337286,0.4230769068047343
2024-04-19,한국카본,7,2,1,10,0.7777776913580343,0.22222219753086697
2024-04-19,한화엔진,7,7,5,19,0.49999996428571686,0.49999996428571686
2024-04-19,한화오션,18,18,10,46,0.4999999861111115,0.4999999861111115
2024-04-20,HD한국조선해양,7,2,1,10,0.7777776913580343,0.22222219753086697
2024-04-20,HD현대마린솔루션,5,1,0,6,0.8333331944444675,0.16666663888889352
2024-04-20,HD현대마린엔진,4,1,0,5,0.799999840000032,0.199999960000008
2024-04-20,HD현대미포,3,1,1,5,0.7499998125000469,0.24999993750001562
2024-04-20,HD현대중공업,7,2,2,11,0.7777776913580343,0.22222219753086697
2024-04-20,STX엔진,2,2,1,5,0.49999987500003124,0.49999987500003124
2024-04-20,삼성중공업,5,2,6,13,0.7142856122449125,0.285714244897965
2024-04-20,세진중공업,1,1,0,2,0.499999750000125,0.499999750000125
2024-04-20,한국카본,1,1,0,2,0.499999750000125,0.499999750000125
2024-04-20,한화엔진,6,1,2,9,0.857142734693895,0.1428571224489825
2024-04-20,한화오션,4,2,2,8,0.6666665555555741,0.33333327777778704
2024-04-21,HD한국조선해양,7,4,1,12,0.636363578512402,0.3636363305785154
2024-04-21,HD현대마린솔루션,9,0,1,10,0.9999998888889013,0.0
2024-04-21,HD현대마린엔진,4,0,0,4,0.9999997500000625,0.0
2024-04-21,HD현대미포,8,4,1,13,0.6666666111111158,0.3333333055555579
2024-04-21,HD현대중공업,15,4,6,25,0.7894736426592819,0.21052630470914185
2024-04-21,삼성중공업,5,6,1,12,0.4545454132231443,0.5454544958677732
2024-04-21,한화엔진,1,1,1,3,0.499999750000125,0.499999750000125
2024-04-21,한화오션,14,6,3,23,0.6999999650000017,0.29999998500000075
2024-04-22,HD한국조선해양,16,8,3,27,0.66666663888889,0.333333319444445
2024-04-22,HD현대마린솔루션,9,6,4,19,0.5999999600000027,0.39999997333333515
2024-04-22,HD현대마린엔진,5,1,0,6,0.8333331944444675,0.16666663888889352
2024-04-22,HD현대미포,21,2,2,25,0.9130434385633287,0.08695651795841226
2024-04-22,HD현대중공업,38,9,3,50,0.8085106210955187,0.19148935762788602
2024-04-22,STX엔진,1,0,0,1,0.9999990000010001,0.0
2024-04-22,삼성중공업,20,9,9,38,0.689655148632581,0.3103448168846615
2024-04-22,세진중공업,1,0,0,1,0.9999990000010001,0.0
2024-04-22,한국카본,1,0,0,1,0.9999990000010001,0.0
2024-04-22,한화엔진,34,5,1,40,0.8717948494411578,0.12820512491781733
2024-04-22,한화오션,70,10,9,89,0.8749999890625002,0.12499999843750002
2024-04-23,HD한국조선해양,17,20,15,52,0.4594594470416366,0.5405405259313372
2024-04-23,HD현대마린솔루션,14,1,2,17,0.9333332711111153,0.06666666222222252
2024-04-23,HD현대마린엔진,3,0,0,3,0.9999996666667778,0.0
2024-04-23,HD현대미포,13,13,4,30,0.49999998076923147,0.49999998076923147
2024-04-23,HD현대중공업,32,24,14,70,0.57142856122449,0.42857142091836753
2024-04-23,STX엔진,4,2,3,9,0.6666665555555741,0.33333327777778704
2024-04-23,삼성중공업,48,19,15,82,0.7164178997549567,0.2835820853196704
2024-04-23,세진중공업,3,2,0,5,0.599999880000024,0.399999920000016
2024-04-23,한국카본,4,4,0,8,0.4999999375000079,0.4999999375000079
2024-04-23,한화엔진,15,12,5,32,0.5555555349794246,0.44444442798353967
2024-04-23,한화오션,39,32,20,91,0.5492957669113272,0.45070421900416596
2024-04-24,HD한국조선해양,15,12,1,28,0.5555555349794246,0.44444442798353967
2024-04-24,HD현대마린솔루션,14,6,3,23,0.6999999650000017,0.29999998500000075
2024-04-24,HD현대마린엔진,6,1,1,8,0.857142734693895,0.1428571224489825
2024-04-24,HD현대미포,7,5,0,12,0.5833332847222263,0.41666663194444736
2024-04-24,HD현대중공업,33,13,1,47,0.7173912887523634,0.28260868950850676
2024-04-24,STX엔진,12,3,1,16,0.7999999466666703,0.19999998666666757
2024-04-24,삼성중공업,15,9,11,35,0.6249999739583344,0.37499998437500065
2024-04-24,세진중공업,1,2,0,3,0.33333322222225925,0.6666664444445185
2024-04-24,한국카본,0,2,0,2,0.0,0.99999950000025
2024-04-24,한화엔진,19,26,4,49,0.4222222128395064,0.5777777649382719
2024-04-24,한화오션,82,39,2,123,0.6776859448125129,0.3223140469230244
2024-04-25,HD한국조선해양,33,32,3,68,0.507692299881657,0.49230768473372793
2024-04-25,HD현대마린솔루션,60,12,3,75,0.8333333217592594,0.1666666643518519
2024-04-25,HD현대마린엔진,5,1,0,6,0.8333331944444675,0.16666663888889352
2024-04-25,HD현대미포,20,14,4,38,0.5882352768166096,0.41176469377162667
2024-04-25,HD현대중공업,64,34,6,104,0.653061217825906,0.34693877197001255
2024-04-25,STX엔진,8,2,0,10,0.7999999200000081,0.19999998000000202
2024-04-25,삼성중공업,18,14,6,38,0.5624999824218756,0.4374999863281255
2024-04-25,세진중공업,0,1,0,1,0.0,0.9999990000010001
2024-04-25,한국카본,4,1,0,5,0.799999840000032,0.199999960000008
2024-04-25,한화엔진,25,12,1,38,0.6756756574141715,0.3243243155588023
2024-04-25,한화오션,32,24,12,68,0.57142856122449,0.42857142091836753
2024-04-26,HD한국조선해양,10,21,1,32,0.3225806347554634,0.677419332986473
2024-04-26,HD현대마린솔루션,14,3,4,21,0.8235293633218022,0.17647057785467188
2024-04-26,HD현대마린엔진,3,0,0,3,0.9999996666667778,0.0
2024-04-26,HD현대미포,7,16,1,24,0.3043478128544429,0.6956521436672981
2024-04-26,HD현대중공업,18,25,1,44,0.4186046414277991,0.5813953353163875
2024-04-26,STX엔진,1,1,0,2,0.499999750000125,0.499999750000125
2024-04-26,삼성중공업,12,20,2,34,0.3749999882812504,0.6249999804687506
2024-04-26,세진중공업,0,1,0,1,0.0,0.9999990000010001
2024-04-26,한국카본,0,1,0,1,0.0,0.9999990000010001
2024-04-26,한화엔진,13,4,0,17,0.7647058373702448,0.23529410380622917
2024-04-26,한화오션,24,23,2,49,0.5106382870076961,0.4893616917157087
2024-04-27,HD한국조선해양,3,6,1,10,0.33333329629630043,0.6666665925926009
2024-04-27,HD현대마린솔루션,5,1,1,7,0.8333331944444675,0.16666663888889352
2024-04-27,HD현대마린엔진,1,0,1,2,0.9999990000010001,0.0
2024-04-27,HD현대미포,2,5,0,7,0.285714244897965,0.7142856122449125
2024-04-27,HD현대중공업,5,7,1,13,0.41666663194444736,0.5833332847222263
2024-04-27,STX엔진,2,1,0,3,0.6666664444445185,0.33333322222225925
2024-04-27,삼성중공업,1,8,1,10,0.11111109876543349,0.8888887901234679
2024-04-27,세진중공업,1,0,0,1,0.9999990000010001,0.0
2024-04-27,한국카본,1,0,0,1,0.9999990000010001,0.0
2024-04-27,한화엔진,4,1,0,5,0.799999840000032,0.199999960000008
2024-04-27,한화오션,5,6,2,13,0.4545454132231443,0.5454544958677732
2024-04-28,HD한국조선해양,7,6,3,16,0.5384614970414233,0.4615384260355057
2024-04-28,HD현대마린솔루션,4,3,3,10,0.57142848979593,0.4285713673469475
2024-04-28,HD현대미포,1,1,1,3,0.499999750000125,0.499999750000125
2024-04-28,HD현대중공업,8,10,2,20,0.4444444197530878,0.5555555246913597
2024-04-28,STX엔진,0,1,0,1,0.0,0.9999990000010001
2024-04-28,삼성중공업,18,7,2,27,0.7199999712000011,0.27999998880000043
2024-04-28,한국카본,0,1,0,1,0.0,0.9999990000010001
2024-04-28,한화엔진,6,3,0,9,0.6666665925926009,0.33333329629630043
2024-04-28,한화오션,9,12,2,23,0.4285714081632663,0.5714285442176883
2024-04-29,HD한국조선해양,25,4,3,32,0.8620689357907263,0.13793102972651622
2024-04-29,HD현대마린솔루션,10,2,7,19,0.8333332638888947,0.16666665277777895
2024-04-29,HD현대마린엔진,2,0,0,2,0.99999950000025,0.0
2024-04-29,HD현대미포,9,4,2,15,0.6923076390532585,0.3076922840236705
2024-04-29,HD현대중공업,33,9,5,47,0.7857142670068032,0.2142857091836736
2024-04-29,STX엔진,1,0,0,1,0.9999990000010001,0.0
2024-04-29,삼성중공업,19,17,6,42,0.5277777631172844,0.4722222091049387
2024-04-29,세진중공업,2,0,0,2,0.99999950000025,0.0
2024-04-29,한국카본,2,0,0,2,0.99999950000025,0.0
2024-04-29,한화엔진,12,5,1,18,0.7058823114186875,0.2941176297577865
2024-04-29,한화오션,31,10,1,42,0.7560975425342064,0.24390243307555043
2024-04-30,HD한국조선해양,13,9,4,26,0.590909064049588,0.4090908904958686
2024-04-30,HD현대마린솔루션,8,3,3,14,0.7272726611570308,0.2727272479338866
2024-04-30,HD현대마린엔진,1,0,0,1,0.9999990000010001,0.0
2024-04-30,HD현대미포,3,1,1,5,0.7499998125000469,0.24999993750001562
2024-04-30,HD현대중공업,19,4,6,29,0.8260869206049165,0.17391303591682453
2024-04-30,STX엔진,1,0,0,1,0.9999990000010001,0.0
2024-04-30,삼성중공업,5,5,5,15,0.499999950000005,0.499999950000005
2024-04-30,세진중공업,1,0,0,1,0.9999990000010001,0.0
2024-04-30,한국카본,1,0,0,1,0.9999990000010001,0.0
2024-04-30,한화엔진,14,1,5,20,0.9333332711111153,0.06666666222222252
2024-04-30,한화오션,21,9,5,35,0.6999999766666675,0.2999999900000003
2024-05-01,HD한국조선해양,8,3,1,12,0.7272726611570308,0.2727272479338866
2024-05-01,HD현대마린솔루션,5,3,2,10,0.6249999218750099,0.3749999531250059
2024-05-01,HD현대미포,3,2,0,5,0.599999880000024,0.399999920000016
2024-05-01,HD현대중공업,13,9,0,22,0.590909064049588,0.4090908904958686
2024-05-01,삼성중공업,10,1,1,12,0.9090908264462886,0.09090908264462885
2024-05-01,한국카본,0,1,0,1,0.0,0.9999990000010001
2024-05-01,한화엔진,5,2,0,7,0.7142856122449125,0.285714244897965
2024-05-01,한화오션,12,8,2,22,0.5999999700000015,0.399999980000001
2024-05-02,HD한국조선해양,17,4,6,27,0.8095237709750585,0.19047618140589612
2024-05-02,HD현대마린솔루션,11,3,8,22,0.7857142295918408,0.21428569897959293
2024-05-02,HD현대미포,11,0,2,13,0.9999999090909174,0.0
2024-05-02,HD현대중공업,46,2,6,54,0.958333313368056,0.041666665798611134
2024-05-02,STX엔진,5,2,0,7,0.7142856122449125,0.285714244897965
2024-05-02,삼성중공업,15,3,5,23,0.8333332870370396,0.1666666574074079
2024-05-02,세진중공업,4,3,0,7,0.57142848979593,0.4285713673469475
2024-05-02,한국카본,4,3,0,7,0.57142848979593,0.4285713673469475
2024-05-02,한화엔진,11,5,1,17,0.6874999570312527,0.3124999804687512
2024-05-02,한화오션,22,9,11,42,0.7096773964620194,0.29032257127991706
2024-05-03,HD한국조선해양,44,17,1,62,0.721311463585058,0.2786885200214997
2024-05-03,HD현대마린솔루션,10,0,6,16,0.99999990000001,0.0
2024-05-03,HD현대마린엔진,0,0,1,1,0.0,0.0
2024-05-03,HD현대미포,12,4,1,17,0.7499999531250029,0.24999998437500096
2024-05-03,HD현대중공업,65,14,1,80,0.8227847997115848,0.1772151876301875
2024-05-03,삼성중공업,10,7,3,20,0.588235259515573,0.4117646816609011
2024-05-03,한국카본,8,3,1,12,0.7272726611570308,0.2727272479338866
2024-05-03,한화엔진,16,3,1,20,0.8421052188365674,0.15789472853185638
2024-05-03,한화오션,14,8,1,23,0.6363636074380178,0.36363634710743875
2024-05-04,HD한국조선해양,7,3,0,10,0.699999930000007,0.299999970000003
2024-05-04,HD현대마린솔루션,6,2,2,10,0.7499999062500118,0.24999996875000394
2024-05-04,HD현대마린엔진,2,0,0,2,0.99999950000025,0.0
2024-05-04,HD현대미포,2,0,0,2,0.99999950000025,0.0
2024-05-04,HD현대중공업,7,2,1,10,0.7777776913580343,0.22222219753086697
2024-05-04,삼성중공업,5,1,1,7,0.8333331944444675,0.16666663888889352
2024-05-04,세진중공업,0,1,0,1,0.0,0.9999990000010001
2024-05-04,한국카본,1,0,0,1,0.9999990000010001,0.0
2024-05-04,한화엔진,3,1,2,6,0.7499998125000469,0.24999993750001562
2024-05-04,한화오션,7,2,0,9,0.7777776913580343,0.22222219753086697
2024-05-05,HD한국조선해양,6,0,1,7,0.9999998333333611,0.0
2024-05-05,HD현대마린솔루션,3,1,1,5,0.7499998125000469,0.24999993750001562
2024-05-05,HD현대마린엔진,1,0,0,1,0.9999990000010001,0.0
2024-05-05,HD현대중공업,13,2,0,15,0.8666666088888928,0.13333332444444504
2024-05-05,삼성중공업,0,0,2,2,0.0,0.0
2024-05-05,한화엔진,5,1,1,7,0.8333331944444675,0.16666663888889352
2024-05-05,한화오션,6,0,2,8,0.9999998333333611,0.0
2024-05-06,HD한국조선해양,9,6,4,19,0.5999999600000027,0.39999997333333515
2024-05-06,HD현대마린솔루션,9,3,5,17,0.7499999375000053,0.2499999791666684
2024-05-06,HD현대마린엔진,4,0,0,4,0.9999997500000625,0.0
2024-05-06,HD현대미포,1,0,0,1,0.9999990000010001,0.0
2024-05-06,HD현대중공업,12,3,0,15,0.7999999466666703,0.19999998666666757
2024-05-06,삼성중공업,11,5,3,19,0.6874999570312527,0.3124999804687512
2024-05-06,한국카본,1,0,0,1,0.9999990000010001,0.0
2024-05-06,한화엔진,3,1,2,6,0.7499998125000469,0.24999993750001562
2024-05-06,한화오션,10,6,4,20,0.6249999609375024,0.37499997656250145
2024-05-07,HD한국조선해양,14,10,6,30,0.5833333090277788,0.41666664930555625
2024-05-07,HD현대마린솔루션,14,5,6,25,0.7368420664819965,0.26315788088642733
2024-05-07,HD현대마린엔진,4,0,2,6,0.9999997500000625,0.0
2024-05-07,HD현대미포,7,5,0,12,0.5833332847222263,0.41666663194444736
2024-05-07,HD현대중공업,37,4,11,52,0.9024390023795366,0.09756097323022017
2024-05-07,STX엔진,0,1,1,2,0.0,0.9999990000010001
2024-05-07,삼성중공업,14,7,4,25,0.6666666349206364,0.3333333174603182
2024-05-07,세진중공업,0,1,0,1,0.0,0.9999990000010001
2024-05-07,한국카본,0,2,0,2,0.0,0.99999950000025
2024-05-07,한화엔진,13,2,4,19,0.8666666088888928,0.13333332444444504
2024-05-07,한화오션,24,8,12,44,0.7499999765625008,0.24999999218750027
2024-05-08,HD한국조선해양,16,6,7,29,0.7272726942148775,0.27272726033057904
2024-05-08,HD현대마린솔루션,55,82,33,170,0.40145985108423465,0.5985401416164954
2024-05-08,HD현대마린엔진,4,7,2,13,0.3636363305785154,0.636363578512402
2024-05-08,HD현대미포,5,3,1,9,0.6249999218750099,0.3749999531250059
2024-05-08,HD현대중공업,21,8,6,35,0.7241379060642101,0.27586205945303244
2024-05-08,STX엔진,1,2,0,3,0.33333322222225925,0.6666664444445185
2024-05-08,삼성중공업,10,6,3,19,0.6249999609375024,0.37499997656250145
2024-05-08,세진중공업,0,2,1,3,0.0,0.99999950000025
2024-05-08,한국카본,1,1,0,2,0.499999750000125,0.499999750000125
2024-05-08,한화엔진,15,3,2,20,0.8333332870370396,0.1666666574074079
2024-05-08,한화오션,15,9,6,30,0.6249999739583344,0.37499998437500065
2024-05-09,HD한국조선해양,12,4,4,20,0.7499999531250029,0.24999998437500096
2024-05-09,HD현대마린솔루션,18,12,30,60,0.5999999800000007,0.3999999866666671
2024-05-09,HD현대마린엔진,2,4,1,7,0.33333327777778704,0.6666665555555741
2024-05-09,HD현대미포,9,3,0,12,0.7499999375000053,0.2499999791666684
2024-05-09,HD현대중공업,26,5,5,36,0.8387096503642048,0.1612903173777317
2024-05-09,STX엔진,1,2,0,3,0.33333322222225925,0.6666664444445185
2024-05-09,삼성중공업,12,7,6,25,0.6315789141274255,0.36842103324099823
2024-05-09,세진중공업,1,3,0,4,0.24999993750001562,0.7499998125000469
2024-05-09,한국카본,2,2,0,4,0.49999987500003124,0.49999987500003124
2024-05-09,한화엔진,10,3,3,16,0.7692307100591762,0.23076921301775286
2024-05-09,한화오션,13,2,8,23,0.8666666088888928,0.13333332444444504
2024-05-10,HD한국조선해양,11,4,3,18,0.7333332844444478,0.2666666488888901
2024-05-10,HD현대마린솔루션,10,13,9,32,0.4347825897920613,0.5652173667296797
2024-05-10,HD현대마린엔진,2,1,0,3,0.6666664444445185,0.33333322222225925
2024-05-10,HD현대미포,7,1,0,8,0.8749998906250137,0.12499998437500197
2024-05-10,HD현대중공업,32,3,5,40,0.9142856881632662,0.0857142832653062
2024-05-10,삼성중공업,20,5,4,29,0.7999999680000013,0.19999999200000032
2024-05-10,한국카본,0,1,0,1,0.0,0.9999990000010001
2024-05-10,한화엔진,14,1,1,16,0.9333332711111153,0.06666666222222252
2024-05-10,한화오션,29,4,5,38,0.878787852157944,0.12121211753902675
2024-05-11,HD한국조선해양,3,3,0,6,0.49999991666668053,0.49999991666668053
2024-05-11,HD현대마린솔루션,2,0,2,4,0.99999950000025,0.0
2024-05-11,HD현대마린엔진,0,0,1,1,0.0,0.0
2024-05-11,HD현대미포,2,3,0,5,0.399999920000016,0.599999880000024
2024-05-11,HD현대중공업,10,2,1,13,0.8333332638888947,0.16666665277777895
2024-05-11,STX엔진,0,2,0,2,0.0,0.99999950000025
2024-05-11,삼성중공업,5,3,0,8,0.6249999218750099,0.3749999531250059
2024-05-11,세진중공업,0,2,0,2,0.0,0.99999950000025
2024-05-11,한국카본,0,3,0,3,0.0,0.9999996666667778
2024-05-11,한화엔진,2,2,0,4,0.49999987500003124,0.49999987500003124
2024-05-11,한화오션,14,2,1,17,0.8749999453125034,0.12499999218750048
2024-05-12,HD한국조선해양,4,1,1,6,0.799999840000032,0.199999960000008
2024-05-12,HD현대마린솔루션,5,2,3,10,0.7142856122449125,0.285714244897965
2024-05-12,HD현대미포,0,0,1,1,0.0,0.0
2024-05-12,HD현대중공업,10,2,2,14,0.8333332638888947,0.16666665277777895
2024-05-12,삼성중공업,9,1,1,11,0.8999999100000091,0.09999999000000101
2024-05-12,한화엔진,2,0,0,2,0.99999950000025,0.0
2024-05-12,한화오션,11,1,1,13,0.9166665902777842,0.08333332638888948
2024-05-13,HD한국조선해양,17,12,12,41,0.5862068763376939,0.41379308917954866
2024-05-13,HD현대마린솔루션,8,11,10,29,0.4210526094182837,0.5789473379501401
2024-05-13,HD현대마린엔진,0,1,2,3,0.0,0.9999990000010001
2024-05-13,HD현대미포,9,6,4,19,0.5999999600000027,0.39999997333333515
2024-05-13,HD현대중공업,25,13,11,49,0.6578947195290864,0.34210525415512494
2024-05-13,STX엔진,0,2,0,2,0.0,0.99999950000025
2024-05-13,삼성중공업,23,10,8,41,0.6969696758494038,0.30303029384756686
2024-05-13,세진중공업,0,2,0,2,0.0,0.99999950000025
2024-05-13,한국카본,2,3,0,5,0.399999920000016,0.599999880000024
2024-05-13,한화엔진,2,5,4,11,0.285714244897965,0.7142856122449125
2024-05-13,한화오션,25,9,17,51,0.7352940960207619,0.2647058745674743
2024-05-14,HD한국조선해양,18,6,2,26,0.7499999687500013,0.24999998958333375
2024-05-14,HD현대마린솔루션,13,10,8,31,0.5652173667296797,0.4347825897920613
2024-05-14,HD현대마린엔진,2,1,0,3,0.6666664444445185,0.33333322222225925
2024-05-14,HD현대미포,3,4,0,7,0.4285713673469475,0.57142848979593
2024-05-14,HD현대중공업,25,10,4,39,0.7142856938775517,0.28571427755102063
2024-05-14,STX엔진,1,1,0,2,0.499999750000125,0.499999750000125
2024-05-14,삼성중공업,10,8,8,26,0.5555555246913597,0.4444444197530878
2024-05-14,세진중공업,0,1,0,1,0.0,0.9999990000010001
2024-05-14,한국카본,0,1,0,1,0.0,0.9999990000010001
2024-05-14,한화엔진,7,1,2,10,0.8749998906250137,0.12499998437500197
2024-05-14,한화오션,18,8,10,36,0.6923076656804744,0.30769229585798863
2024-05-15,HD한국조선해양,15,8,5,28,0.6521738846880919,0.34782607183364905
2024-05-15,HD현대마린솔루션,4,0,3,7,0.9999997500000625,0.0
2024-05-15,HD현대미포,2,1,0,3,0.6666664444445185,0.33333322222225925
2024-05-15,HD현대중공업,11,3,4,18,0.7857142295918408,0.21428569897959293
2024-05-15,STX엔진,1,0,0,1,0.9999990000010001,0.0
2024-05-15,삼성중공업,13,5,5,23,0.7222221820987677,0.27777776234567986
2024-05-15,한국카본,1,0,0,1,0.9999990000010001,0.0
2024-05-15,한화엔진,3,0,7,10,0.9999996666667778,0.0
2024-05-15,한화오션,20,4,6,30,0.8333332986111125,0.1666666597222225
2024-05-16,HD한국조선해양,21,4,3,28,0.8399999664000013,0.15999999360000025
2024-05-16,HD현대마린솔루션,7,4,7,18,0.636363578512402,0.3636363305785154
2024-05-16,HD현대마린엔진,1,0,0,1,0.9999990000010001,0.0
2024-05-16,HD현대미포,11,2,1,14,0.8461537810650938,0.15384614201183525
2024-05-16,HD현대중공업,28,5,5,38,0.8484848227731873,0.15151514692378343
2024-05-16,STX엔진,1,1,0,2,0.499999750000125,0.499999750000125
2024-05-16,삼성중공업,16,0,4,20,0.9999999375000038,0.0
2024-05-16,세진중공업,1,0,1,2,0.9999990000010001,0.0
2024-05-16,한국카본,2,0,0,2,0.99999950000025,0.0
2024-05-16,한화엔진,8,2,2,12,0.7999999200000081,0.19999998000000202
2024-05-16,한화오션,21,8,8,37,0.7241379060642101,0.27586205945303244
2024-05-17,HD한국조선해양,17,3,6,26,0.8499999575000021,0.14999999250000037
2024-05-17,HD현대마린솔루션,6,1,2,9,0.857142734693895,0.1428571224489825
2024-05-17,HD현대미포,8,2,0,10,0.7999999200000081,0.19999998000000202
2024-05-17,HD현대중공업,22,3,10,35,0.8799999648000014,0.11999999520000018
2024-05-17,삼성중공업,12,1,9,22,0.9230768520710114,0.07692307100591762
2024-05-17,세진중공업,1,0,0,1,0.9999990000010001,0.0
2024-05-17,한화엔진,5,1,4,10,0.8333331944444675,0.16666663888889352
2024-05-17,한화오션,71,16,53,140,0.8160919446426214,0.18390804386312593
2024-05-18,HD한국조선해양,8,3,2,13,0.7272726611570308,0.2727272479338866
2024-05-18,HD현대마린솔루션,4,6,0,10,0.39999996000000404,0.599999940000006
2024-05-18,HD현대마린엔진,1,1,0,2,0.499999750000125,0.499999750000125
2024-05-18,HD현대미포,4,6,0,10,0.39999996000000404,0.599999940000006
2024-05-18,HD현대중공업,6,2,2,10,0.7499999062500118,0.24999996875000394
2024-05-18,삼성중공업,7,1,2,10,0.8749998906250137,0.12499998437500197
2024-05-18,세진중공업,0,1,0,1,0.0,0.9999990000010001
2024-05-18,한국카본,1,0,0,1,0.9999990000010001,0.0
2024-05-18,한화엔진,1,0,1,2,0.9999990000010001,0.0
2024-05-18,한화오션,6,2,1,9,0.7499999062500118,0.24999996875000394
2024-05-19,HD한국조선해양,1,4,0,5,0.199999960000008,0.799999840000032
2024-05-19,HD현대마린솔루션,5,1,2,8,0.8333331944444675,0.16666663888889352
2024-05-19,HD현대미포,4,2,1,7,0.6666665555555741,0.33333327777778704
2024-05-19,HD현대중공업,13,4,1,18,0.7647058373702448,0.23529410380622917
2024-05-19,삼성중공업,7,5,1,13,0.5833332847222263,0.41666663194444736
2024-05-19,한화엔진,3,2,0,5,0.599999880000024,0.399999920000016
2024-05-19,한화오션,14,4,2,20,0.7777777345679036,0.2222222098765439
2024-05-20,HD한국조선해양,17,8,4,29,0.679999972800001,0.3199999872000005
2024-05-20,HD현대마린솔루션,9,8,3,20,0.5294117335640156,0.47058820761245834
2024-05-20,HD현대마린엔진,1,2,0,3,0.33333322222225925,0.6666664444445185
2024-05-20,HD현대미포,8,6,0,14,0.5714285306122479,0.42857139795918586
2024-05-20,HD현대중공업,31,6,5,42,0.8378378151935726,0.16216215777940116
2024-05-20,STX엔진,3,0,0,3,0.9999996666667778,0.0
2024-05-20,삼성중공업,17,3,6,26,0.8499999575000021,0.14999999250000037
2024-05-20,세진중공업,0,1,0,1,0.0,0.9999990000010001
2024-05-20,한국카본,2,1,0,3,0.6666664444445185,0.33333322222225925
2024-05-20,한화엔진,11,3,2,16,0.7857142295918408,0.21428569897959293
2024-05-20,한화오션,25,7,5,37,0.7812499755859383,0.21874999316406274
2024-05-21,HD한국조선해양,12,5,5,22,0.7058823114186875,0.2941176297577865
2024-05-21,HD현대마린솔루션,7,5,7,19,0.5833332847222263,0.41666663194444736
2024-05-21,HD현대마린엔진,2,0,1,3,0.99999950000025,0.0
2024-05-21,HD현대미포,4,4,0,8,0.4999999375000079,0.4999999375000079
2024-05-21,HD현대중공업,19,9,7,35,0.6785714043367356,0.32142855994898
2024-05-21,STX엔진,0,1,0,1,0.0,0.9999990000010001
2024-05-21,삼성중공업,18,9,4,31,0.6666666419753096,0.3333333209876548
2024-05-21,세진중공업,4,2,0,6,0.6666665555555741,0.33333327777778704
2024-05-21,한화엔진,16,4,1,21,0.799999960000002,0.1999999900000005
2024-05-21,한화오션,28,10,2,40,0.7368420858725767,0.26315788781163457
2024-05-22,HD한국조선해양,20,9,5,34,0.689655148632581,0.3103448168846615
2024-05-22,HD현대마린솔루션,30,4,5,39,0.8823529152249143,0.11764705536332191
2024-05-22,HD현대마린엔진,18,2,0,20,0.8999999550000022,0.09999999500000024
2024-05-22,HD현대미포,8,1,1,10,0.8888887901234679,0.11111109876543349
2024-05-22,HD현대중공업,24,4,4,32,0.8571428265306134,0.14285713775510223
2024-05-22,STX엔진,2,0,0,2,0.99999950000025,0.0
2024-05-22,삼성중공업,16,9,7,32,0.639999974400001,0.35999998560000057
2024-05-22,세진중공업,2,1,0,3,0.6666664444445185,0.33333322222225925
2024-05-22,한국카본,8,3,0,11,0.7272726611570308,0.2727272479338866
2024-05-22,한화엔진,17,2,1,20,0.8947367950138528,0.10526315235457093
2024-05-22,한화오션,18,19,4,41,0.48648647333820344,0.5135134996347703
2024-05-23,HD한국조선해양,17,5,1,23,0.7727272376033073,0.2272727169421492
2024-05-23,HD현대마린솔루션,9,7,8,24,0.5624999648437522,0.4374999726562517
2024-05-23,HD현대마린엔진,6,1,0,7,0.857142734693895,0.1428571224489825
2024-05-23,HD현대미포,7,1,2,10,0.8749998906250137,0.12499998437500197
2024-05-23,HD현대중공업,21,4,8,33,0.8399999664000013,0.15999999360000025
2024-05-23,STX엔진,1,2,0,3,0.33333322222225925,0.6666664444445185
2024-05-23,삼성중공업,22,6,5,33,0.7857142576530622,0.21428570663265334
2024-05-23,세진중공업,4,2,0,6,0.6666665555555741,0.33333327777778704
2024-05-23,한국카본,2,2,1,5,0.49999987500003124,0.49999987500003124
2024-05-23,한화엔진,8,3,0,11,0.7272726611570308,0.2727272479338866
2024-05-23,한화오션,16,10,3,29,0.6153845917159773,0.3846153698224858
2024-05-24,HD한국조선해양,36,4,4,44,0.8999999775000006,0.09999999750000006
2024-05-24,HD현대마린솔루션,2,3,5,10,0.399999920000016,0.599999880000024
2024-05-24,HD현대미포,7,1,2,10,0.8749998906250137,0.12499998437500197
2024-05-24,HD현대중공업,49,3,7,59,0.9423076741863909,0.05769230658284026
2024-05-24,STX엔진,0,2,0,2,0.0,0.99999950000025
2024-05-24,삼성중공업,9,4,7,20,0.6923076390532585,0.3076922840236705
2024-05-24,세진중공업,0,3,0,3,0.0,0.9999996666667778
2024-05-24,한국카본,0,1,0,1,0.0,0.9999990000010001
2024-05-24,한화엔진,6,3,2,11,0.6666665925926009,0.33333329629630043
2024-05-24,한화오션,80,13,4,97,0.8602150445138167,0.13978494473349523
2024-05-25,HD한국조선해양,4,6,0,10,0.39999996000000404,0.599999940000006
2024-05-25,HD현대마린솔루션,2,1,0,3,0.6666664444445185,0.33333322222225925
2024-05-25,HD현대미포,1,2,1,4,0.33333322222225925,0.6666664444445185
2024-05-25,HD현대중공업,6,3,1,10,0.6666665925926009,0.33333329629630043
2024-05-25,STX엔진,0,2,0,2,0.0,0.99999950000025
2024-05-25,삼성중공업,2,6,1,9,0.24999996875000394,0.7499999062500118
2024-05-25,세진중공업,0,2,0,2,0.0,0.99999950000025
2024-05-25,한국카본,0,2,0,2,0.0,0.99999950000025
2024-05-25,한화엔진,4,4,0,8,0.4999999375000079,0.4999999375000079
2024-05-25,한화오션,8,5,0,13,0.615384568047341,0.3846153550295881
2024-05-26,HD한국조선해양,13,4,1,18,0.7647058373702448,0.23529410380622917
2024-05-26,HD현대마린솔루션,2,0,0,2,0.99999950000025,0.0
2024-05-26,HD현대마린엔진,1,0,0,1,0.9999990000010001,0.0
2024-05-26,HD현대미포,3,0,1,4,0.9999996666667778,0.0
2024-05-26,HD현대중공업,15,4,2,21,0.7894736426592819,0.21052630470914185
2024-05-26,삼성중공업,3,2,2,7,0.599999880000024,0.399999920000016
2024-05-26,한국카본,1,0,0,1,0.9999990000010001,0.0
2024-05-26,한화엔진,5,1,0,6,0.8333331944444675,0.16666663888889352
2024-05-26,한화오션,8,4,1,13,0.6666666111111158,0.3333333055555579
2024-05-27,HD한국조선해양,23,6,3,32,0.7931034209274682,0.20689654458977433
2024-05-27,HD현대마린솔루션,14,3,1,18,0.8235293633218022,0.17647057785467188
2024-05-27,HD현대마린엔진,1,0,0,1,0.9999990000010001,0.0
2024-05-27,HD현대미포,8,1,1,10,0.8888887901234679,0.11111109876543349
2024-05-27,HD현대중공업,28,5,3,36,0.8484848227731873,0.15151514692378343
2024-05-27,STX엔진,2,0,0,2,0.99999950000025,0.0
2024-05-27,삼성중공업,12,4,3,19,0.7499999531250029,0.24999998437500096
2024-05-27,한국카본,2,0,0,2,0.99999950000025,0.0
2024-05-27,한화엔진,17,1,2,20,0.9444443919753115,0.055555552469135974
2024-05-27,한화오션,29,6,3,38,0.8285714048979599,0.1714285665306124
2024-05-28,HD한국조선해양,19,6,2,27,0.7599999696000012,0.23999999040000036
2024-05-28,HD현대마린솔루션,10,3,4,17,0.7692307100591762,0.23076921301775286
2024-05-28,HD현대마린엔진,0,1,0,1,0.0,0.9999990000010001
2024-05-28,HD현대미포,8,2,0,10,0.7999999200000081,0.19999998000000202
2024-05-28,HD현대중공업,18,6,3,27,0.7499999687500013,0.24999998958333375
2024-05-28,STX엔진,1,0,1,2,0.9999990000010001,0.0
2024-05-28,삼성중공업,10,7,3,20,0.588235259515573,0.4117646816609011
2024-05-28,한국카본,1,0,1,2,0.9999990000010001,0.0
2024-05-28,한화엔진,7,6,2,15,0.5384614970414233,0.4615384260355057
2024-05-28,한화오션,34,9,3,46,0.7906976560302871,0.20930232071389954
2024-05-29,HD한국조선해양,25,6,2,33,0.8064515868886585,0.19354838085327802
2024-05-29,HD현대마린솔루션,8,3,5,16,0.7272726611570308,0.2727272479338866
2024-05-29,HD현대마린엔진,2,0,1,3,0.99999950000025,0.0
2024-05-29,HD현대미포,13,4,2,19,0.7647058373702448,0.23529410380622917
2024-05-29,HD현대중공업,27,6,5,38,0.8181817933884306,0.18181817630854014
2024-05-29,STX엔진,0,1,0,1,0.0,0.9999990000010001
2024-05-29,삼성중공업,36,11,4,51,0.7659574305115441,0.23404254821186068
2024-05-29,세진중공업,3,4,0,7,0.4285713673469475,0.57142848979593
2024-05-29,한국카본,7,4,0,11,0.636363578512402,0.3636363305785154
2024-05-29,한화엔진,11,8,1,20,0.5789473379501401,0.4210526094182837
2024-05-29,한화오션,108,18,5,131,0.8571428503401362,0.14285714172335603
2024-05-30,HD한국조선해양,16,3,5,24,0.8421052188365674,0.15789472853185638
2024-05-30,HD현대마린솔루션,6,5,3,14,0.5454544958677732,0.4545454132231443
2024-05-30,HD현대마린엔진,1,0,1,2,0.9999990000010001,0.0
2024-05-30,HD현대미포,8,1,4,13,0.8888887901234679,0.11111109876543349
2024-05-30,HD현대중공업,27,3,5,35,0.899999970000001,0.09999999666666677
2024-05-30,STX엔진,0,0,1,1,0.0,0.0
2024-05-30,삼성중공업,13,3,8,24,0.8124999492187531,0.18749998828125072
2024-05-30,세진중공업,1,0,2,3,0.9999990000010001,0.0
2024-05-30,한국카본,2,0,1,3,0.99999950000025,0.0
2024-05-30,한화엔진,17,2,1,20,0.8947367950138528,0.10526315235457093
2024-05-30,한화오션,23,3,4,30,0.8846153505917173,0.11538461094674572
2024-05-31,HD한국조선해양,11,5,0,16,0.6874999570312527,0.3124999804687512
2024-05-31,HD현대마린솔루션,6,3,1,10,0.6666665925926009,0.33333329629630043
2024-05-31,HD현대마린엔진,0,1,0,1,0.0,0.9999990000010001
2024-05-31,HD현대미포,1,2,0,3,0.33333322222225925,0.6666664444445185
2024-05-31,HD현대중공업,13,6,1,20,0.684210490304711,0.31578945706371275
2024-05-31,삼성중공업,9,7,3,19,0.5624999648437522,0.4374999726562517
2024-05-31,한화엔진,15,4,1,20,0.7894736426592819,0.21052630470914185
2024-05-31,한화오션,78,19,5,102,0.8041237030502711,0.19587628664045065
2024-06-01,HD한국조선해양,3,2,0,5,0.599999880000024,0.399999920000016
2024-06-01,HD현대마린솔루션,1,3,0,4,0.24999993750001562,0.7499998125000469
2024-06-01,HD현대마린엔진,1,0,0,1,0.9999990000010001,0.0
2024-06-01,HD현대미포,1,1,0,2,0.499999750000125,0.499999750000125
2024-06-01,HD현대중공업,6,2,0,8,0.7499999062500118,0.24999996875000394
2024-06-01,삼성중공업,6,2,1,9,0.7499999062500118,0.24999996875000394
2024-06-01,한화엔진,1,0,0,1,0.9999990000010001,0.0
2024-06-01,한화오션,10,2,2,14,0.8333332638888947,0.16666665277777895
2024-06-02,HD한국조선해양,8,5,1,14,0.615384568047341,0.3846153550295881
2024-06-02,HD현대마린솔루션,4,1,0,5,0.799999840000032,0.199999960000008
2024-06-02,HD현대마린엔진,0,1,0,1,0.0,0.9999990000010001
2024-06-02,HD현대미포,1,0,1,2,0.9999990000010001,0.0
2024-06-02,HD현대중공업,9,4,2,15,0.6923076390532585,0.3076922840236705
2024-06-02,삼성중공업,7,4,3,14,0.636363578512402,0.3636363305785154
2024-06-02,한국카본,0,1,0,1,0.0,0.9999990000010001
2024-06-02,한화엔진,2,2,0,4,0.49999987500003124,0.49999987500003124
2024-06-02,한화오션,18,7,1,26,0.7199999712000011,0.27999998880000043
2024-06-03,HD한국조선해양,17,5,4,26,0.7727272376033073,0.2272727169421492
2024-06-03,HD현대마린솔루션,12,5,0,17,0.7058823114186875,0.2941176297577865
2024-06-03,HD현대마린엔진,9,1,0,10,0.8999999100000091,0.09999999000000101
2024-06-03,HD현대미포,10,5,1,16,0.6666666222222252,0.3333333111111126
2024-06-03,HD현대중공업,20,10,3,33,0.6666666444444451,0.33333332222222256
2024-06-03,STX엔진,0,1,1,2,0.0,0.9999990000010001
2024-06-03,삼성중공업,19,11,6,36,0.6333333122222229,0.36666665444444485
2024-06-03,세진중공업,0,2,1,3,0.0,0.99999950000025
2024-06-03,한국카본,2,1,1,4,0.6666664444445185,0.33333322222225925
2024-06-03,한화엔진,12,4,2,18,0.7499999531250029,0.24999998437500096
2024-06-03,한화오션,69,35,7,111,0.6634615320821007,0.33653845830251483
2024-06-04,HD한국조선해양,31,8,1,40,0.7948717744904674,0.20512819986850772
2024-06-04,HD현대마린솔루션,9,4,5,18,0.6923076390532585,0.3076922840236705
2024-06-04,HD현대마린엔진,3,0,0,3,0.9999996666667778,0.0
2024-06-04,HD현대미포,7,1,1,9,0.8749998906250137,0.12499998437500197
2024-06-04,HD현대중공업,70,12,2,84,0.853658526174896,0.14634146162998218
2024-06-04,STX엔진,1,5,0,6,0.16666663888889352,0.8333331944444675
2024-06-04,삼성중공업,41,8,5,54,0.8367346768013332,0.16326530279050402
2024-06-04,세진중공업,2,5,0,7,0.285714244897965,0.7142856122449125
2024-06-04,한국카본,3,11,1,15,0.21428569897959293,0.7857142295918408
2024-06-04,한화엔진,7,4,1,12,0.636363578512402,0.3636363305785154
2024-06-04,한화오션,40,19,9,68,0.6779660902039646,0.32203389284688316
2024-06-05,HD한국조선해양,15,6,4,25,0.7142856802721105,0.28571427210884415
2024-06-05,HD현대마린솔루션,7,7,4,18,0.49999996428571686,0.49999996428571686
2024-06-05,HD현대마린엔진,1,0,1,2,0.9999990000010001,0.0
2024-06-05,HD현대미포,6,3,1,10,0.6666665925926009,0.33333329629630043
2024-06-05,HD현대중공업,34,6,3,43,0.8499999787500006,0.1499999962500001
2024-06-05,STX엔진,1,0,1,2,0.9999990000010001,0.0
2024-06-05,삼성중공업,60,10,7,77,0.8571428448979594,0.14285714081632656
2024-06-05,세진중공업,1,0,2,3,0.9999990000010001,0.0
2024-06-05,한국카본,1,0,1,2,0.9999990000010001,0.0
2024-06-05,한화엔진,14,1,2,17,0.9333332711111153,0.06666666222222252
2024-06-05,한화오션,32,9,6,47,0.7804877858417614,0.21951218976799539
2024-06-06,HD한국조선해양,6,2,1,9,0.7499999062500118,0.24999996875000394
2024-06-06,HD현대마린솔루션,4,2,4,10,0.6666665555555741,0.33333327777778704
2024-06-06,HD현대마린엔진,1,0,0,1,0.9999990000010001,0.0
2024-06-06,HD현대미포,2,1,0,3,0.6666664444445185,0.33333322222225925
2024-06-06,HD현대중공업,12,3,2,17,0.7999999466666703,0.19999998666666757
2024-06-06,STX엔진,1,0,0,1,0.9999990000010001,0.0
2024-06-06,삼성중공업,14,3,3,20,0.8235293633218022,0.17647057785467188
2024-06-06,세진중공업,1,0,0,1,0.9999990000010001,0.0
2024-06-06,한국카본,2,0,0,2,0.99999950000025,0.0
2024-06-06,한화엔진,4,3,0,7,0.57142848979593,0.4285713673469475
2024-06-06,한화오션,9,4,2,15,0.6923076390532585,0.3076922840236705
2024-06-07,HD한국조선해양,12,7,2,21,0.6315789141274255,0.36842103324099823
2024-06-07,HD현대마린솔루션,6,3,1,10,0.6666665925926009,0.33333329629630043
2024-06-07,HD현대미포,10,0,0,10,0.99999990000001,0.0
2024-06-07,HD현대중공업,21,5,1,27,0.8076922766272201,0.1923076849112429
2024-06-07,STX엔진,0,0,1,1,0.0,0.0
2024-06-07,삼성중공업,13,7,0,20,0.6499999675000016,0.34999998250000086
2024-06-07,세진중공업,4,0,0,4,0.9999997500000625,0.0
2024-06-07,한화엔진,8,3,0,11,0.7272726611570308,0.2727272479338866
2024-06-07,한화오션,35,22,2,59,0.6140350769467531,0.3859649055093876
2024-06-08,HD한국조선해양,3,3,0,6,0.49999991666668053,0.49999991666668053
2024-06-08,HD현대마린솔루션,0,1,0,1,0.0,0.9999990000010001
2024-06-08,HD현대미포,5,0,1,6,0.99999980000004,0.0
2024-06-08,HD현대중공업,1,1,2,4,0.499999750000125,0.499999750000125
2024-06-08,STX엔진,0,1,0,1,0.0,0.9999990000010001
2024-06-08,삼성중공업,3,1,1,5,0.7499998125000469,0.24999993750001562
2024-06-08,한화엔진,4,1,0,5,0.799999840000032,0.199999960000008
2024-06-08,한화오션,4,4,0,8,0.4999999375000079,0.4999999375000079
2024-06-09,HD한국조선해양,5,1,0,6,0.8333331944444675,0.16666663888889352
2024-06-09,HD현대마린솔루션,6,1,0,7,0.857142734693895,0.1428571224489825
2024-06-09,HD현대마린엔진,1,1,0,2,0.499999750000125,0.499999750000125
2024-06-09,HD현대미포,6,2,0,8,0.7499999062500118,0.24999996875000394
2024-06-09,HD현대중공업,10,1,0,11,0.9090908264462886,0.09090908264462885
2024-06-09,삼성중공업,5,0,0,5,0.99999980000004,0.0
2024-06-09,세진중공업,2,0,1,3,0.99999950000025,0.0
2024-06-09,한화엔진,8,0,0,8,0.9999998750000157,0.0
2024-06-09,한화오션,10,2,0,12,0.8333332638888947,0.16666665277777895
2024-06-10,HD한국조선해양,18,6,4,28,0.7499999687500013,0.24999998958333375
2024-06-10,HD현대마린솔루션,11,3,1,15,0.7857142295918408,0.21428569897959293
2024-06-10,HD현대마린엔진,1,0,0,1,0.9999990000010001,0.0
2024-06-10,HD현대미포,19,3,2,24,0.863636324380167,0.13636363016528952
2024-06-10,HD현대중공업,24,5,5,34,0.8275861783590973,0.17241378715814526
2024-06-10,STX엔진,8,3,2,13,0.7272726611570308,0.2727272479338866
2024-06-10,삼성중공업,22,4,2,28,0.8461538136094686,0.15384614792899431
2024-06-10,세진중공업,1,1,1,3,0.499999750000125,0.499999750000125
2024-06-10,한국카본,3,0,0,3,0.9999996666667778,0.0
2024-06-10,한화엔진,12,2,3,17,0.8571427959183717,0.14285713265306196
2024-06-10,한화오션,54,6,3,63,0.8999999850000003,0.09999999833333337
2024-06-11,HD한국조선해양,14,6,5,25,0.6999999650000017,0.29999998500000075
2024-06-11,HD현대마린솔루션,12,5,2,19,0.7058823114186875,0.2941176297577865
2024-06-11,HD현대마린엔진,2,0,0,2,0.99999950000025,0.0
2024-06-11,HD현대미포,11,3,2,16,0.7857142295918408,0.21428569897959293
2024-06-11,HD현대중공업,45,13,6,64,0.7758620555885852,0.22413792717003575
2024-06-11,STX엔진,2,1,0,3,0.6666664444445185,0.33333322222225925
2024-06-11,삼성중공업,12,7,2,21,0.6315789141274255,0.36842103324099823
2024-06-11,한국카본,0,0,1,1,0.0,0.0
2024-06-11,한화엔진,6,4,0,10,0.599999940000006,0.39999996000000404
2024-06-11,한화오션,24,7,5,36,0.7741935234131121,0.22580644432882438
2024-06-12,HD한국조선해양,16,8,2,26,0.66666663888889,0.333333319444445
2024-06-12,HD현대마린솔루션,8,3,1,12,0.7272726611570308,0.2727272479338866
2024-06-12,HD현대마린엔진,1,0,0,1,0.9999990000010001,0.0
2024-06-12,HD현대미포,6,2,2,10,0.7499999062500118,0.24999996875000394
2024-06-12,HD현대중공업,24,7,8,39,0.7741935234131121,0.22580644432882438
2024-06-12,삼성중공업,23,6,5,34,0.7931034209274682,0.20689654458977433
2024-06-12,한국카본,5,0,0,5,0.99999980000004,0.0
2024-06-12,한화엔진,10,2,1,13,0.8333332638888947,0.16666665277777895
2024-06-12,한화오션,26,6,6,38,0.8124999746093758,0.1874999941406252
2024-06-13,HD한국조선해양,30,7,1,38,0.8108107888970058,0.18918918407596802
2024-06-13,HD현대마린솔루션,2,4,1,7,0.33333327777778704,0.6666665555555741
2024-06-13,HD현대미포,10,3,2,15,0.7692307100591762,0.23076921301775286
2024-06-13,HD현대중공업,29,7,5,41,0.8055555331790131,0.19444443904321004
2024-06-13,STX엔진,1,0,0,1,0.9999990000010001,0.0
2024-06-13,삼성중공업,34,7,2,43,0.8292682724568714,0.1707317031528853
2024-06-13,한국카본,2,0,0,2,0.99999950000025,0.0
2024-06-13,한화엔진,11,4,2,17,0.7333332844444478,0.2666666488888901
2024-06-13,한화오션,31,6,2,39,0.8378378151935726,0.16216215777940116
2024-06-14,HD한국조선해양,18,4,1,23,0.8181817809917372,0.18181817355371938
2024-06-14,HD현대마린솔루션,11,7,0,18,0.6111110771604957,0.3888888672839518
2024-06-14,HD현대마린엔진,1,1,0,2,0.499999750000125,0.499999750000125
2024-06-14,HD현대미포,5,2,0,7,0.7142856122449125,0.285714244897965
2024-06-14,HD현대중공업,26,2,5,33,0.9285713954081645,0.07142856887755111
2024-06-14,STX엔진,0,2,0,2,0.0,0.99999950000025
2024-06-14,삼성중공업,19,9,0,28,0.6785714043367356,0.32142855994898
2024-06-14,세진중공업,1,2,0,3,0.33333322222225925,0.6666664444445185
2024-06-14,한화엔진,16,7,1,24,0.6956521436672981,0.3043478128544429
2024-06-14,한화오션,39,9,2,50,0.812499983072917,0.1874999960937501
2024-06-15,HD한국조선해양,1,3,0,4,0.24999993750001562,0.7499998125000469
2024-06-15,HD현대마린솔루션,0,1,0,1,0.0,0.9999990000010001
2024-06-15,HD현대마린엔진,0,1,0,1,0.0,0.9999990000010001
2024-06-15,HD현대미포,0,1,0,1,0.0,0.9999990000010001
2024-06-15,HD현대중공업,5,1,0,6,0.8333331944444675,0.16666663888889352
2024-06-15,삼성중공업,2,4,0,6,0.33333327777778704,0.6666665555555741
2024-06-15,세진중공업,0,2,0,2,0.0,0.99999950000025
2024-06-15,한국카본,0,1,0,1,0.0,0.9999990000010001
2024-06-15,한화엔진,0,3,0,3,0.0,0.9999996666667778
2024-06-15,한화오션,3,6,0,9,0.33333329629630043,0.6666665925926009
2024-06-16,HD한국조선해양,2,5,0,7,0.285714244897965,0.7142856122449125
2024-06-16,HD현대마린솔루션,4,2,0,6,0.6666665555555741,0.33333327777778704
2024-06-16,HD현대마린엔진,0,1,0,1,0.0,0.9999990000010001
2024-06-16,HD현대미포,0,3,0,3,0.0,0.9999996666667778
2024-06-16,HD현대중공업,7,3,0,10,0.699999930000007,0.299999970000003
2024-06-16,STX엔진,0,1,0,1,0.0,0.9999990000010001
2024-06-16,삼성중공업,5,2,0,7,0.7142856122449125,0.285714244897965
2024-06-16,세진중공업,0,1,0,1,0.0,0.9999990000010001
2024-06-16,한국카본,0,1,0,1,0.0,0.9999990000010001
2024-06-16,한화엔진,1,1,0,2,0.499999750000125,0.499999750000125
2024-06-16,한화오션,10,2,1,13,0.8333332638888947,0.16666665277777895
2024-06-17,HD한국조선해양,19,6,1,26,0.7599999696000012,0.23999999040000036
2024-06-17,HD현대마린솔루션,9,1,4,14,0.8999999100000091,0.09999999000000101
2024-06-17,HD현대마린엔진,1,0,0,1,0.9999990000010001,0.0
2024-06-17,HD현대미포,12,4,0,16,0.7499999531250029,0.24999998437500096
2024-06-17,HD현대중공업,34,7,5,46,0.8292682724568714,0.1707317031528853
2024-06-17,STX엔진,0,1,1,2,0.0,0.9999990000010001
2024-06-17,삼성중공업,30,8,3,41,0.7894736634349037,0.21052631024930765
2024-06-17,세진중공업,5,0,1,6,0.99999980000004,0.0
2024-06-17,한국카본,2,1,0,3,0.6666664444445185,0.33333322222225925
2024-06-17,한화엔진,15,6,1,22,0.7142856802721105,0.28571427210884415
2024-06-17,한화오션,23,9,4,36,0.7187499775390632,0.2812499912109378
2024-06-18,HD한국조선해양,18,4,4,26,0.8181817809917372,0.18181817355371938
2024-06-18,HD현대마린솔루션,7,3,0,10,0.699999930000007,0.299999970000003
2024-06-18,HD현대미포,8,0,2,10,0.9999998750000157,0.0
2024-06-18,HD현대중공업,99,5,5,109,0.9519230677699705,0.048076922614644975
2024-06-18,STX엔진,0,1,0,1,0.0,0.9999990000010001
2024-06-18,삼성중공업,17,4,6,27,0.8095237709750585,0.19047618140589612
2024-06-18,세진중공업,3,0,0,3,0.9999996666667778,0.0
2024-06-18,한화엔진,14,4,1,19,0.7777777345679036,0.2222222098765439
2024-06-18,한화오션,21,9,9,39,0.6999999766666675,0.2999999900000003
2024-06-19,HD한국조선해양,19,15,1,35,0.558823512975779,0.44117645761245716
2024-06-19,HD현대마린솔루션,8,1,1,10,0.8888887901234679,0.11111109876543349
2024-06-19,HD현대미포,13,6,0,19,0.684210490304711,0.31578945706371275
2024-06-19,HD현대중공업,119,11,1,131,0.9153846083431953,0.08461538396449705
2024-06-19,STX엔진,13,0,0,13,0.9999999230769291,0.0
2024-06-19,삼성중공업,22,9,2,33,0.7096773964620194,0.29032257127991706
2024-06-19,세진중공업,1,0,0,1,0.9999990000010001,0.0
2024-06-19,한국카본,1,0,0,1,0.9999990000010001,0.0
2024-06-19,한화엔진,17,2,1,20,0.8947367950138528,0.10526315235457093
2024-06-19,한화오션,32,11,3,46,0.7441860292049761,0.25581394753921055
2024-06-20,HD한국조선해양,21,4,4,29,0.8399999664000013,0.15999999360000025
2024-06-20,HD현대마린솔루션,5,2,3,10,0.7142856122449125,0.285714244897965
2024-06-20,HD현대마린엔진,1,0,0,1,0.9999990000010001,0.0
2024-06-20,HD현대미포,13,1,0,14,0.9285713622449028,0.07142856632653098
2024-06-20,HD현대중공업,35,7,1,43,0.833333313492064,0.1666666626984128
2024-06-20,STX엔진,5,2,0,7,0.7142856122449125,0.285714244897965
2024-06-20,삼성중공업,9,4,3,16,0.6923076390532585,0.3076922840236705
2024-06-20,세진중공업,3,0,0,3,0.9999996666667778,0.0
2024-06-20,한국카본,1,0,0,1,0.9999990000010001,0.0
2024-06-20,한화엔진,17,2,0,19,0.8947367950138528,0.10526315235457093
2024-06-20,한화오션,27,15,6,48,0.6428571275510208,0.357142848639456
2024-06-21,HD한국조선해양,15,8,3,26,0.6521738846880919,0.34782607183364905
2024-06-21,HD현대마린솔루션,4,1,0,5,0.799999840000032,0.199999960000008
2024-06-21,HD현대마린엔진,0,1,0,1,0.0,0.9999990000010001
2024-06-21,HD현대미포,2,6,1,9,0.24999996875000394,0.7499999062500118
2024-06-21,HD현대중공업,28,13,6,47,0.6829268126115412,0.31707316299821553
2024-06-21,STX엔진,1,2,1,4,0.33333322222225925,0.6666664444445185
2024-06-21,삼성중공업,11,9,3,23,0.5499999725000013,0.4499999775000011
2024-06-21,세진중공업,2,4,0,6,0.33333327777778704,0.6666665555555741
2024-06-21,한국카본,1,1,0,2,0.499999750000125,0.499999750000125
2024-06-21,한화엔진,5,2,2,9,0.7142856122449125,0.285714244897965
2024-06-21,한화오션,98,11,11,120,0.8990825605588756,0.10091743026681257
2024-06-22,HD한국조선해양,8,2,0,10,0.7999999200000081,0.19999998000000202
2024-06-22,HD현대미포,1,0,1,2,0.9999990000010001,0.0
2024-06-22,HD현대중공업,9,3,1,13,0.7499999375000053,0.2499999791666684
2024-06-22,STX엔진,2,0,0,2,0.99999950000025,0.0
2024-06-22,삼성중공업,0,1,1,2,0.0,0.9999990000010001
2024-06-22,한화엔진,2,1,0,3,0.6666664444445185,0.33333322222225925
2024-06-22,한화오션,9,3,4,16,0.7499999375000053,0.2499999791666684
2024-06-23,HD한국조선해양,14,2,3,19,0.8749999453125034,0.12499999218750048
2024-06-23,HD현대마린솔루션,7,1,2,10,0.8749998906250137,0.12499998437500197
2024-06-23,HD현대미포,1,1,2,4,0.499999750000125,0.499999750000125
2024-06-23,HD현대중공업,12,1,8,21,0.9230768520710114,0.07692307100591762
2024-06-23,삼성중공업,1,2,1,4,0.33333322222225925,0.6666664444445185
2024-06-23,세진중공업,0,0,1,1,0.0,0.0
2024-06-23,한화엔진,3,0,0,3,0.9999996666667778,0.0
2024-06-23,한화오션,13,3,2,18,0.8124999492187531,0.18749998828125072
2024-06-24,HD한국조선해양,24,9,5,38,0.7272727052341605,0.2727272644628102
2024-06-24,HD현대마린솔루션,9,2,4,15,0.8181817438016598,0.1818181652892577
2024-06-24,HD현대마린엔진,0,1,0,1,0.0,0.9999990000010001
2024-06-24,HD현대미포,10,3,4,17,0.7692307100591762,0.23076921301775286
2024-06-24,HD현대중공업,24,6,7,37,0.7999999733333342,0.19999999333333354
2024-06-24,STX엔진,1,1,1,3,0.499999750000125,0.499999750000125
2024-06-24,삼성중공업,8,6,3,17,0.5714285306122479,0.42857139795918586
2024-06-24,세진중공업,2,4,4,10,0.33333327777778704,0.6666665555555741
2024-06-24,한국카본,1,1,0,2,0.499999750000125,0.499999750000125
2024-06-24,한화엔진,9,6,2,17,0.5999999600000027,0.39999997333333515
2024-06-24,한화오션,50,16,4,70,0.7575757460973372,0.2424242387511479
2024-06-25,HD한국조선해양,15,10,2,27,0.599999976000001,0.39999998400000064
2024-06-25,HD현대마린솔루션,14,6,1,21,0.6999999650000017,0.29999998500000075
2024-06-25,HD현대마린엔진,1,0,1,2,0.9999990000010001,0.0
2024-06-25,HD현대미포,6,3,1,10,0.6666665925926009,0.33333329629630043
2024-06-25,HD현대중공업,22,11,2,35,0.6666666464646471,0.33333332323232356
2024-06-25,STX엔진,2,2,0,4,0.49999987500003124,0.49999987500003124
2024-06-25,삼성중공업,8,7,2,17,0.5333332977777802,0.46666663555555765
2024-06-25,세진중공업,3,2,0,5,0.599999880000024,0.399999920000016
2024-06-25,한국카본,1,1,0,2,0.499999750000125,0.499999750000125
2024-06-25,한화엔진,21,5,0,26,0.8076922766272201,0.1923076849112429
2024-06-25,한화오션,27,13,0,40,0.6749999831250004,0.3249999918750002
2024-06-26,HD한국조선해양,19,8,0,27,0.7037036776406045,0.2962962853223598
2024-06-26,HD현대마린솔루션,9,5,1,15,0.6428570969387788,0.3571428316326549
2024-06-26,HD현대마린엔진,0,1,0,1,0.0,0.9999990000010001
2024-06-26,HD현대미포,5,2,0,7,0.7142856122449125,0.285714244897965
2024-06-26,HD현대중공업,23,9,0,32,0.7187499775390632,0.2812499912109378
2024-06-26,STX엔진,1,0,0,1,0.9999990000010001,0.0
2024-06-26,삼성중공업,14,9,1,24,0.6086956257088858,0.39130433081285515
2024-06-26,한국카본,1,0,0,1,0.9999990000010001,0.0
2024-06-26,한화엔진,16,2,0,18,0.8888888395061756,0.11111110493827195
2024-06-26,한화오션,30,9,3,42,0.769230749506904,0.2307692248520712
2024-06-27,HD한국조선해양,31,5,3,39,0.8611110871913588,0.1388888850308643
2024-06-27,HD현대마린솔루션,13,5,2,20,0.7222221820987677,0.27777776234567986
2024-06-27,HD현대미포,3,2,0,5,0.599999880000024,0.399999920000016
2024-06-27,HD현대중공업,32,6,7,45,0.8421052409972306,0.15789473268698073
2024-06-27,STX엔진,1,0,0,1,0.9999990000010001,0.0
2024-06-27,삼성중공업,17,3,1,21,0.8499999575000021,0.14999999250000037
2024-06-27,세진중공업,0,1,0,1,0.0,0.9999990000010001
2024-06-27,한국카본,2,0,0,2,0.99999950000025,0.0
2024-06-27,한화엔진,8,3,0,11,0.7272726611570308,0.2727272479338866
2024-06-27,한화오션,18,6,2,26,0.7499999687500013,0.24999998958333375
2024-06-28,HD한국조선해양,20,5,2,27,0.7999999680000013,0.19999999200000032
2024-06-28,HD현대마린솔루션,8,6,0,14,0.5714285306122479,0.42857139795918586
2024-06-28,HD현대미포,7,2,0,9,0.7777776913580343,0.22222219753086697
2024-06-28,HD현대중공업,21,6,0,27,0.7777777489711944,0.22222221399176983
2024-06-28,삼성중공업,10,4,2,16,0.7142856632653098,0.2857142653061239
2024-06-28,세진중공업,0,1,0,1,0.0,0.9999990000010001
2024-06-28,한국카본,0,1,0,1,0.0,0.9999990000010001
2024-06-28,한화엔진,16,3,0,19,0.8421052188365674,0.15789472853185638
2024-06-28,한화오션,26,9,7,42,0.7428571216326537,0.2571428497959186
2024-06-29,HD한국조선해양,7,1,0,8,0.8749998906250137,0.12499998437500197
2024-06-29,HD현대마린솔루션,4,1,0,5,0.799999840000032,0.199999960000008
2024-06-29,HD현대마린엔진,1,0,0,1,0.9999990000010001,0.0
2024-06-29,HD현대미포,0,2,0,2,0.0,0.99999950000025
2024-06-29,HD현대중공업,7,2,1,10,0.7777776913580343,0.22222219753086697
2024-06-29,삼성중공업,4,1,1,6,0.799999840000032,0.199999960000008
2024-06-29,세진중공업,0,1,0,1,0.0,0.9999990000010001
2024-06-29,한화엔진,3,0,0,3,0.9999996666667778,0.0
2024-06-29,한화오션,8,2,0,10,0.7999999200000081,0.19999998000000202
2024-06-30,HD한국조선해양,1,2,0,3,0.33333322222225925,0.6666664444445185
2024-06-30,HD현대마린솔루션,4,4,3,11,0.4999999375000079,0.4999999375000079
2024-06-30,HD현대중공업,7,2,1,10,0.7777776913580343,0.22222219753086697
2024-06-30,삼성중공업,0,2,3,5,0.0,0.99999950000025
2024-06-30,한화엔진,7,3,1,11,0.699999930000007,0.299999970000003
2024-06-30,한화오션,9,5,3,17,0.6428570969387788,0.3571428316326549
2024-07-01,HD한국조선해양,26,4,3,33,0.8666666377777787,0.13333332888888902
2024-07-01,HD현대마린솔루션,19,6,3,28,0.7599999696000012,0.23999999040000036
2024-07-01,HD현대마린엔진,1,0,0,1,0.9999990000010001,0.0
2024-07-01,HD현대미포,21,5,2,28,0.8076922766272201,0.1923076849112429
2024-07-01,HD현대중공업,16,6,4,26,0.7272726942148775,0.27272726033057904
2024-07-01,STX엔진,0,1,0,1,0.0,0.9999990000010001
2024-07-01,삼성중공업,24,9,2,35,0.7272727052341605,0.2727272644628102
2024-07-01,세진중공업,1,0,0,1,0.9999990000010001,0.0
2024-07-01,한국카본,2,0,0,2,0.99999950000025,0.0
2024-07-01,한화엔진,29,2,0,31,0.9354838407908438,0.06451612695109267
2024-07-01,한화오션,66,14,9,89,0.8249999896875001,0.17499999781250003
2024-07-02,HD한국조선해양,20,9,2,31,0.689655148632581,0.3103448168846615
2024-07-02,HD현대마린솔루션,16,2,5,23,0.8888888395061756,0.11111110493827195
2024-07-02,HD현대미포,13,6,2,21,0.684210490304711,0.31578945706371275
2024-07-02,HD현대중공업,22,10,4,36,0.6874999785156257,0.3124999902343753
2024-07-02,STX엔진,4,4,0,8,0.4999999375000079,0.4999999375000079
2024-07-02,삼성중공업,55,42,2,99,0.5670103034328835,0.4329896862578383
2024-07-02,세진중공업,3,2,0,5,0.599999880000024,0.399999920000016
2024-07-02,한국카본,3,2,0,5,0.599999880000024,0.399999920000016
2024-07-02,한화엔진,23,7,2,32,0.7666666411111119,0.2333333255555558
2024-07-02,한화오션,53,24,9,86,0.6883116793725756,0.3116883076404116
2024-07-03,HD한국조선해양,21,10,3,34,0.677419332986473,0.3225806347554634
2024-07-03,HD현대마린솔루션,12,3,4,19,0.7999999466666703,0.19999998666666757
2024-07-03,HD현대미포,7,8,0,15,0.46666663555555765,0.5333332977777802
2024-07-03,HD현대중공업,21,10,4,35,0.677419332986473,0.3225806347554634
2024-07-03,STX엔진,1,0,0,1,0.9999990000010001,0.0
2024-07-03,삼성중공업,14,10,3,27,0.5833333090277788,0.41666664930555625
2024-07-03,세진중공업,2,0,0,2,0.99999950000025,0.0
2024-07-03,한국카본,2,0,0,2,0.99999950000025,0.0
2024-07-03,한화엔진,13,3,4,20,0.8124999492187531,0.18749998828125072
2024-07-03,한화오션,26,9,2,37,0.7428571216326537,0.2571428497959186
2024-07-04,HD한국조선해양,22,3,3,28,0.8799999648000014,0.11999999520000018
2024-07-04,HD현대마린솔루션,12,2,3,17,0.8571427959183717,0.14285713265306196
2024-07-04,HD현대마린엔진,2,0,0,2,0.99999950000025,0.0
2024-07-04,HD현대미포,10,3,0,13,0.7692307100591762,0.23076921301775286
2024-07-04,HD현대중공업,23,4,3,30,0.8518518203017844,0.1481481426611799
2024-07-04,STX엔진,0,1,0,1,0.0,0.9999990000010001
2024-07-04,삼성중공업,13,9,1,23,0.590909064049588,0.4090908904958686
2024-07-04,세진중공업,0,2,0,2,0.0,0.99999950000025
2024-07-04,한국카본,1,1,0,2,0.499999750000125,0.499999750000125
2024-07-04,한화엔진,16,6,0,22,0.7272726942148775,0.27272726033057904
2024-07-04,한화오션,24,7,6,37,0.7741935234131121,0.22580644432882438
2024-07-05,HD한국조선해양,15,3,2,20,0.8333332870370396,0.1666666574074079
2024-07-05,HD현대마린솔루션,7,2,3,12,0.7777776913580343,0.22222219753086697
2024-07-05,HD현대미포,8,1,1,10,0.8888887901234679,0.11111109876543349
2024-07-05,HD현대중공업,18,5,4,27,0.7826086616257103,0.21739129489603065
2024-07-05,STX엔진,0,0,1,1,0.0,0.0
2024-07-05,삼성중공업,10,5,0,15,0.6666666222222252,0.3333333111111126
2024-07-05,한국카본,1,0,0,1,0.9999990000010001,0.0
2024-07-05,한화엔진,6,3,1,10,0.6666665925926009,0.33333329629630043
2024-07-05,한화오션,22,11,2,35,0.6666666464646471,0.33333332323232356
2024-07-06,HD한국조선해양,6,1,0,7,0.857142734693895,0.1428571224489825
2024-07-06,HD현대마린솔루션,1,0,1,2,0.9999990000010001,0.0
2024-07-06,HD현대미포,3,0,0,3,0.9999996666667778,0.0
2024-07-06,HD현대중공업,6,1,0,7,0.857142734693895,0.1428571224489825
2024-07-06,삼성중공업,3,1,1,5,0.7499998125000469,0.24999993750001562
2024-07-06,한화엔진,1,0,0,1,0.9999990000010001,0.0
2024-07-06,한화오션,5,3,1,9,0.6249999218750099,0.3749999531250059
2024-07-07,HD한국조선해양,6,1,1,8,0.857142734693895,0.1428571224489825
2024-07-07,HD현대마린솔루션,3,3,1,7,0.49999991666668053,0.49999991666668053
2024-07-07,HD현대미포,1,0,0,1,0.9999990000010001,0.0
2024-07-07,HD현대중공업,10,1,1,12,0.9090908264462886,0.09090908264462885
2024-07-07,삼성중공업,2,0,0,2,0.99999950000025,0.0
2024-07-07,한국카본,2,0,0,2,0.99999950000025,0.0
2024-07-07,한화엔진,4,0,1,5,0.9999997500000625,0.0
2024-07-07,한화오션,10,2,0,12,0.8333332638888947,0.16666665277777895
2024-07-08,HD한국조선해양,15,5,2,22,0.7499999625000018,0.2499999875000006
2024-07-08,HD현대마린솔루션,6,5,2,13,0.5454544958677732,0.4545454132231443
2024-07-08,HD현대미포,11,3,2,16,0.7857142295918408,0.21428569897959293
2024-07-08,HD현대중공업,20,5,3,28,0.7999999680000013,0.19999999200000032
2024-07-08,STX엔진,0,1,0,1,0.0,0.9999990000010001
2024-07-08,삼성중공업,14,8,2,24,0.6363636074380178,0.36363634710743875
2024-07-08,세진중공업,0,2,0,2,0.0,0.99999950000025
2024-07-08,한국카본,3,1,0,4,0.7499998125000469,0.24999993750001562
2024-07-08,한화엔진,16,5,1,22,0.7619047256235845,0.23809522675737013
2024-07-08,한화오션,20,7,7,34,0.7407407133058995,0.2592592496570648
2024-07-09,HD한국조선해양,23,7,6,36,0.7666666411111119,0.2333333255555558
2024-07-09,HD현대마린솔루션,11,5,3,19,0.6874999570312527,0.3124999804687512
2024-07-09,HD현대마린엔진,1,3,0,4,0.24999993750001562,0.7499998125000469
2024-07-09,HD현대미포,21,5,1,27,0.8076922766272201,0.1923076849112429
2024-07-09,HD현대중공업,60,9,4,73,0.8695652047889101,0.13043478071833653
2024-07-09,STX엔진,1,0,0,1,0.9999990000010001,0.0
2024-07-09,삼성중공업,10,7,3,20,0.588235259515573,0.4117646816609011
2024-07-09,한국카본,1,0,1,2,0.9999990000010001,0.0
2024-07-09,한화엔진,7,4,2,13,0.636363578512402,0.3636363305785154
2024-07-09,한화오션,23,7,7,37,0.7666666411111119,0.2333333255555558
2024-07-10,HD한국조선해양,16,13,2,31,0.5517241189060649,0.4482758466111777
2024-07-10,HD현대마린솔루션,10,10,3,23,0.4999999750000012,0.4999999750000012
2024-07-10,HD현대마린엔진,1,1,0,2,0.499999750000125,0.499999750000125
2024-07-10,HD현대미포,14,12,1,27,0.5384615177514801,0.4615384437869829
2024-07-10,HD현대중공업,27,9,4,40,0.7499999791666673,0.24999999305555576
2024-07-10,STX엔진,0,1,1,2,0.0,0.9999990000010001
2024-07-10,삼성중공업,15,11,4,30,0.5769230547337286,0.4230769068047343
2024-07-10,세진중공업,1,1,0,2,0.499999750000125,0.499999750000125
2024-07-10,한국카본,1,0,0,1,0.9999990000010001,0.0
2024-07-10,한화엔진,12,5,2,19,0.7058823114186875,0.2941176297577865
2024-07-10,한화오션,29,7,6,42,0.8055555331790131,0.19444443904321004
2024-07-11,HD한국조선해양,17,5,1,23,0.7727272376033073,0.2272727169421492
2024-07-11,HD현대마린솔루션,6,8,9,23,0.42857139795918586,0.5714285306122479
2024-07-11,HD현대미포,7,3,1,11,0.699999930000007,0.299999970000003
2024-07-11,HD현대중공업,49,5,6,60,0.9074073906035669,0.092592590877915
2024-07-11,STX엔진,1,0,1,2,0.9999990000010001,0.0
2024-07-11,삼성중공업,8,4,2,14,0.6666666111111158,0.3333333055555579
2024-07-11,한국카본,1,0,0,1,0.9999990000010001,0.0
2024-07-11,한화엔진,16,2,0,18,0.8888888395061756,0.11111110493827195
2024-07-11,한화오션,32,4,5,41,0.8888888641975317,0.11111110802469146
2024-07-12,HD한국조선해양,13,2,2,17,0.8666666088888928,0.13333332444444504
2024-07-12,HD현대마린솔루션,8,4,6,18,0.6666666111111158,0.3333333055555579
2024-07-12,HD현대미포,3,0,2,5,0.9999996666667778,0.0
2024-07-12,HD현대중공업,20,5,5,30,0.7999999680000013,0.19999999200000032
2024-07-12,삼성중공업,7,8,2,17,0.46666663555555765,0.5333332977777802
2024-07-12,한국카본,1,0,0,1,0.9999990000010001,0.0
2024-07-12,한화엔진,27,5,3,35,0.8437499736328133,0.15624999511718765
2024-07-12,한화오션,44,11,3,58,0.7999999854545458,0.19999999636363644
2024-07-13,HD한국조선해양,3,1,0,4,0.7499998125000469,0.24999993750001562
2024-07-13,HD현대마린솔루션,6,0,0,6,0.9999998333333611,0.0
2024-07-13,HD현대미포,3,0,0,3,0.9999996666667778,0.0
2024-07-13,HD현대중공업,7,1,1,9,0.8749998906250137,0.12499998437500197
2024-07-13,한화엔진,6,2,0,8,0.7499999062500118,0.24999996875000394
2024-07-13,한화오션,6,4,0,10,0.599999940000006,0.39999996000000404
2024-07-14,HD한국조선해양,5,4,1,10,0.5555554938271674,0.44444439506173394
2024-07-14,HD현대마린솔루션,10,1,1,12,0.9090908264462886,0.09090908264462885
2024-07-14,HD현대마린엔진,1,0,0,1,0.9999990000010001,0.0
2024-07-14,HD현대미포,7,3,0,10,0.699999930000007,0.299999970000003
2024-07-14,HD현대중공업,11,1,2,14,0.9166665902777842,0.08333332638888948
2024-07-14,삼성중공업,6,2,0,8,0.7499999062500118,0.24999996875000394
2024-07-14,세진중공업,1,0,0,1,0.9999990000010001,0.0
2024-07-14,한화엔진,9,1,0,10,0.8999999100000091,0.09999999000000101
2024-07-14,한화오션,14,2,3,19,0.8749999453125034,0.12499999218750048
2024-07-15,HD한국조선해양,131,30,5,166,0.8136645912194747,0.18633540256934533
2024-07-15,HD현대마린솔루션,9,4,2,15,0.6923076390532585,0.3076922840236705
2024-07-15,HD현대미포,12,2,0,14,0.8571427959183717,0.14285713265306196
2024-07-15,HD현대중공업,194,16,11,221,0.9238095194104309,0.0761904758276644
2024-07-15,STX엔진,13,1,0,14,0.9285713622449028,0.07142856632653098
2024-07-15,삼성중공업,15,8,2,25,0.6521738846880919,0.34782607183364905
2024-07-15,한국카본,2,1,0,3,0.6666664444445185,0.33333322222225925
2024-07-15,한화엔진,39,5,0,44,0.8863636162190087,0.11363636105371908
2024-07-15,한화오션,35,5,5,45,0.8749999781250006,0.12499999687500009
2024-07-16,HD한국조선해양,32,16,7,55,0.6666666527777781,0.3333333263888891
2024-07-16,HD현대마린솔루션,5,7,3,15,0.41666663194444736,0.5833332847222263
2024-07-16,HD현대마린엔진,7,5,1,13,0.5833332847222263,0.41666663194444736
2024-07-16,HD현대미포,5,12,0,17,0.2941176297577865,0.7058823114186875
2024-07-16,HD현대중공업,64,14,7,85,0.8205128099934256,0.17948717718606183
2024-07-16,STX엔진,10,0,0,10,0.99999990000001,0.0
2024-07-16,삼성중공업,13,9,1,23,0.590909064049588,0.4090908904958686
2024-07-16,세진중공업,1,1,0,2,0.499999750000125,0.499999750000125
2024-07-16,한국카본,3,0,0,3,0.9999996666667778,0.0
2024-07-16,한화엔진,21,2,0,23,0.9130434385633287,0.08695651795841226
2024-07-16,한화오션,30,9,3,42,0.769230749506904,0.2307692248520712
2024-07-17,HD한국조선해양,60,21,10,91,0.7407407315957935,0.25925925605852773
2024-07-17,HD현대마린솔루션,4,10,13,27,0.2857142653061239,0.7142856632653098
2024-07-17,HD현대마린엔진,3,11,4,18,0.21428569897959293,0.7857142295918408
2024-07-17,HD현대미포,7,7,1,15,0.49999996428571686,0.49999996428571686
2024-07-17,HD현대중공업,63,15,15,93,0.8076922973372783,0.1923076898422091
2024-07-17,STX엔진,0,2,0,2,0.0,0.99999950000025
2024-07-17,삼성중공업,25,18,15,58,0.5813953353163875,0.4186046414277991
2024-07-17,세진중공업,1,0,2,3,0.9999990000010001,0.0
2024-07-17,한국카본,3,0,0,3,0.9999996666667778,0.0
2024-07-17,한화엔진,12,13,5,30,0.4799999808000007,0.5199999792000009
2024-07-17,한화오션,23,18,18,59,0.560975596073766,0.43902437953599077
2024-07-18,HD한국조선해양,19,8,5,32,0.7037036776406045,0.2962962853223598
2024-07-18,HD현대마린솔루션,6,5,5,16,0.5454544958677732,0.4545454132231443
2024-07-18,HD현대마린엔진,1,1,0,2,0.499999750000125,0.499999750000125
2024-07-18,HD현대미포,8,2,1,11,0.7999999200000081,0.19999998000000202
2024-07-18,HD현대중공업,28,4,6,38,0.874999972656251,0.12499999609375013
2024-07-18,삼성중공업,11,12,8,31,0.4782608487712674,0.5217391077504736
2024-07-18,세진중공업,0,1,0,1,0.0,0.9999990000010001
2024-07-18,한국카본,2,0,0,2,0.99999950000025,0.0
2024-07-18,한화엔진,6,3,1,10,0.6666665925926009,0.33333329629630043
2024-07-18,한화오션,57,8,9,74,0.8769230634319529,0.12307692118343198
2024-07-19,HD한국조선해양,12,10,3,25,0.5454545206611581,0.4545454338842984
2024-07-19,HD현대마린솔루션,6,3,4,13,0.6666665925926009,0.33333329629630043
2024-07-19,HD현대마린엔진,7,1,1,9,0.8749998906250137,0.12499998437500197
2024-07-19,HD현대미포,11,7,2,20,0.6111110771604957,0.3888888672839518
2024-07-19,HD현대중공업,18,10,6,34,0.64285711989796,0.35714284438775556
2024-07-19,삼성중공업,12,7,8,27,0.6315789141274255,0.36842103324099823
2024-07-19,세진중공업,11,2,0,13,0.8461537810650938,0.15384614201183525
2024-07-19,한국카본,14,1,0,15,0.9333332711111153,0.06666666222222252
2024-07-19,한화엔진,16,2,3,21,0.8888888395061756,0.11111110493827195
2024-07-19,한화오션,19,8,7,34,0.7037036776406045,0.2962962853223598
2024-07-20,HD한국조선해양,8,4,2,14,0.6666666111111158,0.3333333055555579
2024-07-20,HD현대마린솔루션,1,0,0,1,0.9999990000010001,0.0
2024-07-20,HD현대미포,7,1,0,8,0.8749998906250137,0.12499998437500197
2024-07-20,HD현대중공업,9,3,1,13,0.7499999375000053,0.2499999791666684
2024-07-20,STX엔진,0,1,0,1,0.0,0.9999990000010001
2024-07-20,삼성중공업,2,2,2,6,0.49999987500003124,0.49999987500003124
2024-07-20,세진중공업,2,0,0,2,0.99999950000025,0.0
2024-07-20,한국카본,2,0,0,2,0.99999950000025,0.0
2024-07-20,한화엔진,2,2,1,5,0.49999987500003124,0.49999987500003124
2024-07-20,한화오션,8,4,1,13,0.6666666111111158,0.3333333055555579
2024-07-21,HD한국조선해양,10,2,2,14,0.8333332638888947,0.16666665277777895
2024-07-21,HD현대마린솔루션,5,3,0,8,0.6249999218750099,0.3749999531250059
2024-07-21,HD현대마린엔진,1,2,0,3,0.33333322222225925,0.6666664444445185
2024-07-21,HD현대미포,7,2,1,10,0.7777776913580343,0.22222219753086697
2024-07-21,HD현대중공업,14,3,8,25,0.8235293633218022,0.17647057785467188
2024-07-21,삼성중공업,3,4,3,10,0.4285713673469475,0.57142848979593
2024-07-21,세진중공업,0,1,0,1,0.0,0.9999990000010001
2024-07-21,한국카본,5,1,0,6,0.8333331944444675,0.16666663888889352
2024-07-21,한화엔진,2,1,0,3,0.6666664444445185,0.33333322222225925
2024-07-21,한화오션,5,2,3,10,0.7142856122449125,0.285714244897965
2024-07-22,HD한국조선해양,22,12,18,52,0.6470588044982705,0.35294116608996573
2024-07-22,HD현대마린솔루션,7,1,3,11,0.8749998906250137,0.12499998437500197
2024-07-22,HD현대마린엔진,1,0,1,2,0.9999990000010001,0.0
2024-07-22,HD현대미포,10,4,1,15,0.7142856632653098,0.2857142653061239
2024-07-22,HD현대중공업,29,8,17,54,0.7837837626004389,0.21621621037253486
2024-07-22,삼성중공업,19,5,4,28,0.7916666336805569,0.20833332465277812
2024-07-22,세진중공업,1,1,0,2,0.499999750000125,0.499999750000125
2024-07-22,한국카본,2,0,0,2,0.99999950000025,0.0
2024-07-22,한화엔진,12,3,3,18,0.7999999466666703,0.19999998666666757
2024-07-22,한화오션,101,7,19,127,0.9351851765260633,0.06481481421467765
2024-07-23,HD한국조선해양,37,13,6,56,0.7399999852000003,0.25999999480000013
2024-07-23,HD현대마린솔루션,14,9,2,25,0.6086956257088858,0.39130433081285515
2024-07-23,HD현대마린엔진,2,2,0,4,0.49999987500003124,0.49999987500003124
2024-07-23,HD현대미포,10,5,3,18,0.6666666222222252,0.3333333111111126
2024-07-23,HD현대중공업,75,18,10,103,0.8064516042317033,0.19354838501560878
2024-07-23,STX엔진,1,0,0,1,0.9999990000010001,0.0
2024-07-23,삼성중공업,17,10,2,29,0.6296296063100145,0.37037035665294976
2024-07-23,세진중공업,3,0,1,4,0.9999996666667778,0.0
2024-07-23,한국카본,2,5,0,7,0.285714244897965,0.7142856122449125
2024-07-23,한화엔진,14,5,1,20,0.7368420664819965,0.26315788088642733
2024-07-23,한화오션,33,8,7,48,0.8048780291493164,0.19512194646044034
2024-07-24,HD한국조선해양,15,6,5,26,0.7142856802721105,0.28571427210884415
2024-07-24,HD현대마린솔루션,11,5,3,19,0.6874999570312527,0.3124999804687512
2024-07-24,HD현대마린엔진,8,3,0,11,0.7272726611570308,0.2727272479338866
2024-07-24,HD현대미포,4,1,0,5,0.799999840000032,0.199999960000008
2024-07-24,HD현대중공업,26,10,4,40,0.7222222021604945,0.2777777700617286
2024-07-24,STX엔진,0,2,0,2,0.0,0.99999950000025
2024-07-24,삼성중공업,9,4,6,19,0.6923076390532585,0.3076922840236705
2024-07-24,한국카본,1,2,2,5,0.33333322222225925,0.6666664444445185
2024-07-24,한화엔진,12,5,1,18,0.7058823114186875,0.2941176297577865
2024-07-24,한화오션,26,6,5,37,0.8124999746093758,0.1874999941406252
2024-07-25,HD한국조선해양,33,40,11,84,0.4520547883280166,0.5479451979733535
2024-07-25,HD현대마린솔루션,16,22,0,38,0.4210526204986153,0.578947353185596
2024-07-25,HD현대마린엔진,4,6,0,10,0.39999996000000404,0.599999940000006
2024-07-25,HD현대미포,25,25,1,51,0.4999999900000002,0.4999999900000002
2024-07-25,HD현대중공업,40,35,9,84,0.5333333262222223,0.46666666044444455
2024-07-25,STX엔진,0,2,0,2,0.0,0.99999950000025
2024-07-25,삼성중공업,13,12,4,29,0.5199999792000009,0.4799999808000007
2024-07-25,세진중공업,0,1,0,1,0.0,0.9999990000010001
2024-07-25,한국카본,1,2,0,3,0.33333322222225925,0.6666664444445185
2024-07-25,한화엔진,11,7,2,20,0.6111110771604957,0.3888888672839518
2024-07-25,한화오션,17,5,6,28,0.7727272376033073,0.2272727169421492
2024-07-26,HD한국조선해양,19,34,10,63,0.35849055927376305,0.6415094218583128
2024-07-26,HD현대마린솔루션,6,10,2,18,0.37499997656250145,0.6249999609375024
2024-07-26,HD현대마린엔진,3,8,0,11,0.2727272479338866,0.7272726611570308
2024-07-26,HD현대미포,17,35,3,55,0.3269230706360948,0.6730769101331364
2024-07-26,HD현대중공업,37,49,11,97,0.4302325531368308,0.5697674352352624
2024-07-26,STX엔진,1,6,2,9,0.1428571224489825,0.857142734693895
2024-07-26,삼성중공업,17,36,14,67,0.3207547109291564,0.6792452702029195
2024-07-26,세진중공업,1,3,0,4,0.24999993750001562,0.7499998125000469
2024-07-26,한국카본,3,6,0,9,0.33333329629630043,0.6666665925926009
2024-07-26,한화엔진,6,13,1,20,0.31578945706371275,0.684210490304711
2024-07-26,한화오션,93,54,40,187,0.6326530569207275,0.36734693627655146
2024-07-27,HD한국조선해양,3,1,2,6,0.7499998125000469,0.24999993750001562
2024-07-27,HD현대마린솔루션,1,1,0,2,0.499999750000125,0.499999750000125
2024-07-27,HD현대마린엔진,0,1,0,1,0.0,0.9999990000010001
2024-07-27,HD현대미포,6,2,0,8,0.7499999062500118,0.24999996875000394
2024-07-27,HD현대중공업,8,2,0,10,0.7999999200000081,0.19999998000000202
2024-07-27,STX엔진,0,1,0,1,0.0,0.9999990000010001
2024-07-27,삼성중공업,5,2,1,8,0.7142856122449125,0.285714244897965
2024-07-27,한화엔진,2,1,0,3,0.6666664444445185,0.33333322222225925
2024-07-27,한화오션,6,3,1,10,0.6666665925926009,0.33333329629630043
2024-07-28,HD한국조선해양,9,5,5,19,0.6428570969387788,0.3571428316326549
2024-07-28,HD현대마린솔루션,1,3,2,6,0.24999993750001562,0.7499998125000469
2024-07-28,HD현대마린엔진,0,1,0,1,0.0,0.9999990000010001
2024-07-28,HD현대미포,6,4,1,11,0.599999940000006,0.39999996000000404
2024-07-28,HD현대중공업,12,7,4,23,0.6315789141274255,0.36842103324099823
2024-07-28,삼성중공업,8,8,3,19,0.4999999687500019,0.4999999687500019
2024-07-28,세진중공업,0,1,0,1,0.0,0.9999990000010001
2024-07-28,한화엔진,4,3,0,7,0.57142848979593,0.4285713673469475
2024-07-28,한화오션,11,5,4,20,0.6874999570312527,0.3124999804687512
2024-07-29,HD한국조선해양,17,18,6,41,0.4857142718367351,0.5142856995918372
2024-07-29,HD현대마린솔루션,27,7,2,36,0.7941176237024229,0.20588234688581333
2024-07-29,HD현대마린엔진,1,0,1,2,0.9999990000010001,0.0
2024-07-29,HD현대미포,11,15,3,29,0.4230769068047343,0.5769230547337286
2024-07-29,HD현대중공업,15,18,9,42,0.45454544077135034,0.5454545289256204
2024-07-29,STX엔진,0,2,0,2,0.0,0.99999950000025
2024-07-29,삼성중공업,18,17,8,43,0.5142856995918372,0.4857142718367351
2024-07-29,세진중공업,0,1,0,1,0.0,0.9999990000010001
2024-07-29,한국카본,3,2,0,5,0.599999880000024,0.399999920000016
2024-07-29,한화엔진,6,1,3,10,0.857142734693895,0.1428571224489825
2024-07-29,한화오션,21,21,9,51,0.49999998809523843,0.49999998809523843
2024-07-30,HD한국조선해양,24,13,3,40,0.6486486311176046,0.35135134185536915
2024-07-30,HD현대마린솔루션,11,4,5,20,0.7333332844444478,0.2666666488888901
2024-07-30,HD현대마린엔진,31,2,0,33,0.9393939109274573,0.060606058769513374
2024-07-30,HD현대미포,8,12,3,23,0.399999980000001,0.5999999700000015
2024-07-30,HD현대중공업,63,14,10,87,0.8181818075560805,0.18181817945690676
2024-07-30,STX엔진,1,0,0,1,0.9999990000010001,0.0
2024-07-30,삼성중공업,13,14,6,33,0.48148146364883465,0.5185184993141296
2024-07-30,세진중공업,1,1,0,2,0.499999750000125,0.499999750000125
2024-07-30,한국카본,1,1,0,2,0.499999750000125,0.499999750000125
2024-07-30,한화엔진,16,5,1,22,0.7619047256235845,0.23809522675737013
2024-07-30,한화오션,48,20,8,76,0.7058823425605538,0.2941176427335641
2024-07-31,HD한국조선해양,12,13,5,30,0.4799999808000007,0.5199999792000009
2024-07-31,HD현대마린솔루션,6,4,4,14,0.599999940000006,0.39999996000000404
2024-07-31,HD현대마린엔진,8,3,0,11,0.7272726611570308,0.2727272479338866
2024-07-31,HD현대미포,4,11,3,18,0.2666666488888901,0.7333332844444478
2024-07-31,HD현대중공업,21,17,7,45,0.5526315644044325,0.4473684092797787
2024-07-31,STX엔진,0,2,0,2,0.0,0.99999950000025
2024-07-31,삼성중공업,12,5,7,24,0.7058823114186875,0.2941176297577865
2024-07-31,세진중공업,0,1,0,1,0.0,0.9999990000010001
2024-07-31,한국카본,1,1,0,2,0.499999750000125,0.499999750000125
2024-07-31,한화엔진,14,8,0,22,0.6363636074380178,0.36363634710743875
2024-07-31,한화오션,24,12,9,45,0.6666666481481487,0.33333332407407434
2024-08-01,HD한국조선해양,12,10,5,27,0.5454545206611581,0.4545454338842984
2024-08-01,HD현대마린솔루션,4,1,1,6,0.799999840000032,0.199999960000008
2024-08-01,HD현대마린엔진,1,1,2,4,0.499999750000125,0.499999750000125
2024-08-01,HD현대미포,4,6,2,12,0.39999996000000404,0.599999940000006
2024-08-01,HD현대중공업,21,14,5,40,0.5999999828571434,0.39999998857142893
2024-08-01,STX엔진,0,2,1,3,0.0,0.99999950000025
2024-08-01,삼성중공업,12,10,5,27,0.5454545206611581,0.4545454338842984
2024-08-01,세진중공업,0,4,0,4,0.0,0.9999997500000625
2024-08-01,한국카본,2,7,0,9,0.22222219753086697,0.7777776913580343
2024-08-01,한화엔진,11,6,3,20,0.6470587854671302,0.35294115570934376
2024-08-01,한화오션,25,21,6,52,0.5434782490548207,0.4565217292060494
2024-08-02,HD한국조선해양,14,9,5,28,0.6086956257088858,0.39130433081285515
2024-08-02,HD현대마린솔루션,8,2,2,12,0.7999999200000081,0.19999998000000202
2024-08-02,HD현대마린엔진,10,3,0,13,0.7692307100591762,0.23076921301775286
2024-08-02,HD현대미포,11,3,1,15,0.7857142295918408,0.21428569897959293
2024-08-02,HD현대중공업,19,4,12,35,0.8260869206049165,0.17391303591682453
2024-08-02,STX엔진,2,3,0,5,0.399999920000016,0.599999880000024
2024-08-02,삼성중공업,16,7,9,32,0.6956521436672981,0.3043478128544429
2024-08-02,세진중공업,8,4,0,12,0.6666666111111158,0.3333333055555579
2024-08-02,한국카본,12,3,0,15,0.7999999466666703,0.19999998666666757
2024-08-02,한화엔진,12,7,3,22,0.6315789141274255,0.36842103324099823
2024-08-02,한화오션,20,10,10,40,0.6666666444444451,0.33333332222222256
2024-08-03,HD한국조선해양,4,6,3,13,0.39999996000000404,0.599999940000006
2024-08-03,HD현대마린솔루션,3,2,0,5,0.599999880000024,0.399999920000016
2024-08-03,HD현대마린엔진,3,2,0,5,0.599999880000024,0.399999920000016
2024-08-03,HD현대미포,1,3,1,5,0.24999993750001562,0.7499998125000469
2024-08-03,HD현대중공업,6,4,2,12,0.599999940000006,0.39999996000000404
2024-08-03,STX엔진,0,0,1,1,0.0,0.0
2024-08-03,삼성중공업,3,5,6,14,0.3749999531250059,0.6249999218750099
2024-08-03,세진중공업,1,3,0,4,0.24999993750001562,0.7499998125000469
2024-08-03,한국카본,1,2,0,3,0.33333322222225925,0.6666664444445185
2024-08-03,한화엔진,3,3,1,7,0.49999991666668053,0.49999991666668053
2024-08-03,한화오션,6,5,7,18,0.5454544958677732,0.4545454132231443
2024-08-04,HD한국조선해양,2,5,5,12,0.285714244897965,0.7142856122449125
2024-08-04,HD현대마린솔루션,2,1,2,5,0.6666664444445185,0.33333322222225925
2024-08-04,HD현대마린엔진,0,1,0,1,0.0,0.9999990000010001
2024-08-04,HD현대미포,1,3,6,10,0.24999993750001562,0.7499998125000469
2024-08-04,HD현대중공업,4,3,9,16,0.57142848979593,0.4285713673469475
2024-08-04,STX엔진,0,1,0,1,0.0,0.9999990000010001
2024-08-04,삼성중공업,4,5,4,13,0.44444439506173394,0.5555554938271674
2024-08-04,세진중공업,2,3,0,5,0.399999920000016,0.599999880000024
2024-08-04,한국카본,1,2,1,4,0.33333322222225925,0.6666664444445185
2024-08-04,한화엔진,2,3,0,5,0.399999920000016,0.599999880000024
2024-08-04,한화오션,6,2,6,14,0.7499999062500118,0.24999996875000394
2024-08-05,HD한국조선해양,11,5,26,42,0.6874999570312527,0.3124999804687512
2024-08-05,HD현대마린솔루션,2,1,2,5,0.6666664444445185,0.33333322222225925
2024-08-05,HD현대마린엔진,1,1,0,2,0.499999750000125,0.499999750000125
2024-08-05,HD현대미포,7,1,15,23,0.8749998906250137,0.12499998437500197
2024-08-05,HD현대중공업,14,6,32,52,0.6999999650000017,0.29999998500000075
2024-08-05,STX엔진,0,1,0,1,0.0,0.9999990000010001
2024-08-05,삼성중공업,14,4,17,35,0.7777777345679036,0.2222222098765439
2024-08-05,한국카본,2,0,0,2,0.99999950000025,0.0
2024-08-05,한화엔진,2,2,1,5,0.49999987500003124,0.49999987500003124
2024-08-05,한화오션,16,3,20,39,0.8421052188365674,0.15789472853185638
2024-08-06,HD한국조선해양,12,40,9,61,0.23076922633136104,0.7692307544378701
2024-08-06,HD현대마린솔루션,3,1,1,5,0.7499998125000469,0.24999993750001562
2024-08-06,HD현대마린엔진,2,1,0,3,0.6666664444445185,0.33333322222225925
2024-08-06,HD현대미포,4,16,3,23,0.1999999900000005,0.799999960000002
2024-08-06,HD현대중공업,17,41,9,67,0.29310344322235443,0.7068965395362666
2024-08-06,STX엔진,0,2,0,2,0.0,0.99999950000025
2024-08-06,삼성중공업,6,32,8,46,0.15789473268698073,0.8421052409972306
2024-08-06,세진중공업,1,1,0,2,0.499999750000125,0.499999750000125
2024-08-06,한국카본,0,1,0,1,0.0,0.9999990000010001
2024-08-06,한화엔진,10,9,2,21,0.5263157617728547,0.47368418559556913
2024-08-06,한화오션,13,30,9,52,0.30232557436452157,0.697674402379665
2024-08-07,HD한국조선해양,42,9,6,57,0.8235293956170707,0.1764705847750866
2024-08-07,HD현대마린솔루션,3,0,1,4,0.9999996666667778,0.0
2024-08-07,HD현대마린엔진,2,0,0,2,0.99999950000025,0.0
2024-08-07,HD현대미포,9,6,2,17,0.5999999600000027,0.39999997333333515
2024-08-07,HD현대중공업,40,10,11,61,0.7999999840000004,0.1999999960000001
2024-08-07,STX엔진,0,1,0,1,0.0,0.9999990000010001
2024-08-07,삼성중공업,24,8,6,38,0.7499999765625008,0.24999999218750027
2024-08-07,세진중공업,1,0,0,1,0.9999990000010001,0.0
2024-08-07,한화엔진,9,4,2,15,0.6923076390532585,0.3076922840236705
2024-08-07,한화오션,24,8,5,37,0.7499999765625008,0.24999999218750027
2024-08-08,HD한국조선해양,6,8,20,34,0.42857139795918586,0.5714285306122479
2024-08-08,HD현대마린솔루션,2,1,5,8,0.6666664444445185,0.33333322222225925
2024-08-08,HD현대마린엔진,2,1,1,4,0.6666664444445185,0.33333322222225925
2024-08-08,HD현대미포,6,1,8,15,0.857142734693895,0.1428571224489825
2024-08-08,HD현대중공업,13,6,17,36,0.684210490304711,0.31578945706371275
2024-08-08,STX엔진,0,1,0,1,0.0,0.9999990000010001
2024-08-08,삼성중공업,25,8,8,41,0.7575757346189171,0.2424242350780535
2024-08-08,세진중공업,2,2,0,4,0.49999987500003124,0.49999987500003124
2024-08-08,한국카본,1,1,0,2,0.499999750000125,0.499999750000125
2024-08-08,한화엔진,6,0,4,10,0.9999998333333611,0.0
2024-08-08,한화오션,15,4,10,29,0.7894736426592819,0.21052630470914185
2024-08-09,HD한국조선해양,21,14,3,38,0.5999999828571434,0.39999998857142893
2024-08-09,HD현대마린솔루션,5,4,2,11,0.5555554938271674,0.44444439506173394
2024-08-09,HD현대미포,35,3,2,40,0.9210526073407209,0.07894736634349037
2024-08-09,HD현대중공업,26,10,7,43,0.7222222021604945,0.2777777700617286
2024-08-09,삼성중공업,12,5,3,20,0.7058823114186875,0.2941176297577865
2024-08-09,한국카본,1,0,0,1,0.9999990000010001,0.0
2024-08-09,한화엔진,7,3,4,14,0.699999930000007,0.299999970000003
2024-08-09,한화오션,13,6,5,24,0.684210490304711,0.31578945706371275
2024-08-10,HD한국조선해양,5,2,0,7,0.7142856122449125,0.285714244897965
2024-08-10,HD현대마린솔루션,1,0,1,2,0.9999990000010001,0.0
2024-08-10,HD현대미포,2,0,0,2,0.99999950000025,0.0
2024-08-10,HD현대중공업,6,1,1,8,0.857142734693895,0.1428571224489825
2024-08-10,삼성중공업,3,1,1,5,0.7499998125000469,0.24999993750001562
2024-08-10,세진중공업,1,0,0,1,0.9999990000010001,0.0
2024-08-10,한화엔진,3,1,0,4,0.7499998125000469,0.24999993750001562
2024-08-10,한화오션,4,1,1,6,0.799999840000032,0.199999960000008
2024-08-11,HD한국조선해양,4,4,2,10,0.4999999375000079,0.4999999375000079
2024-08-11,HD현대마린솔루션,7,4,1,12,0.636363578512402,0.3636363305785154
2024-08-11,HD현대마린엔진,11,0,0,11,0.9999999090909174,0.0
2024-08-11,HD현대미포,6,0,1,7,0.9999998333333611,0.0
2024-08-11,HD현대중공업,10,2,4,16,0.8333332638888947,0.16666665277777895
2024-08-11,삼성중공업,2,2,2,6,0.49999987500003124,0.49999987500003124
2024-08-11,세진중공업,1,0,0,1,0.9999990000010001,0.0
2024-08-11,한화엔진,4,2,0,6,0.6666665555555741,0.33333327777778704
2024-08-11,한화오션,4,3,5,12,0.57142848979593,0.4285713673469475
2024-08-12,HD한국조선해양,8,15,2,25,0.34782607183364905,0.6521738846880919
2024-08-12,HD현대마린솔루션,9,2,0,11,0.8181817438016598,0.1818181652892577
2024-08-12,HD현대마린엔진,9,1,0,10,0.8999999100000091,0.09999999000000101
2024-08-12,HD현대미포,9,3,0,12,0.7499999375000053,0.2499999791666684
2024-08-12,HD현대중공업,18,13,1,32,0.5806451425598341,0.4193548251821024
2024-08-12,삼성중공업,9,11,0,20,0.4499999775000011,0.5499999725000013
2024-08-12,한화엔진,4,1,0,5,0.799999840000032,0.199999960000008
2024-08-12,한화오션,20,7,5,32,0.7407407133058995,0.2592592496570648
2024-08-13,HD한국조선해양,6,9,6,21,0.39999997333333515,0.5999999600000027
2024-08-13,HD현대마린솔루션,9,1,3,13,0.8999999100000091,0.09999999000000101
2024-08-13,HD현대마린엔진,4,0,0,4,0.9999997500000625,0.0
2024-08-13,HD현대미포,6,3,5,14,0.6666665925926009,0.33333329629630043
2024-08-13,HD현대중공업,11,7,5,23,0.6111110771604957,0.3888888672839518
2024-08-13,STX엔진,0,1,1,2,0.0,0.9999990000010001
2024-08-13,삼성중공업,8,8,7,23,0.4999999687500019,0.4999999687500019
2024-08-13,한화엔진,6,2,2,10,0.7499999062500118,0.24999996875000394
2024-08-13,한화오션,16,6,5,27,0.7272726942148775,0.27272726033057904
2024-08-14,HD한국조선해양,20,12,2,34,0.6249999804687506,0.3749999882812504
2024-08-14,HD현대마린솔루션,9,2,2,13,0.8181817438016598,0.1818181652892577
2024-08-14,HD현대마린엔진,12,1,0,13,0.9230768520710114,0.07692307100591762
2024-08-14,HD현대미포,16,2,0,18,0.8888888395061756,0.11111110493827195
2024-08-14,HD현대중공업,19,3,2,24,0.863636324380167,0.13636363016528952
2024-08-14,STX엔진,2,1,1,4,0.6666664444445185,0.33333322222225925
2024-08-14,삼성중공업,16,5,3,24,0.7619047256235845,0.23809522675737013
2024-08-14,세진중공업,10,2,0,12,0.8333332638888947,0.16666665277777895
2024-08-14,한국카본,9,1,0,10,0.8999999100000091,0.09999999000000101
2024-08-14,한화엔진,14,2,0,16,0.8749999453125034,0.12499999218750048
2024-08-14,한화오션,46,5,8,59,0.9019607666282203,0.09803921376393698
2024-08-15,HD한국조선해양,4,6,1,11,0.39999996000000404,0.599999940000006
2024-08-15,HD현대마린솔루션,2,1,0,3,0.6666664444445185,0.33333322222225925
2024-08-15,HD현대마린엔진,1,1,0,2,0.499999750000125,0.499999750000125
2024-08-15,HD현대미포,4,2,2,8,0.6666665555555741,0.33333327777778704
2024-08-15,HD현대중공업,9,2,2,13,0.8181817438016598,0.1818181652892577
2024-08-15,STX엔진,0,1,0,1,0.0,0.9999990000010001
2024-08-15,삼성중공업,6,3,2,11,0.6666665925926009,0.33333329629630043
2024-08-15,세진중공업,5,2,0,7,0.7142856122449125,0.285714244897965
2024-08-15,한국카본,2,2,0,4,0.49999987500003124,0.49999987500003124
2024-08-15,한화엔진,2,3,0,5,0.399999920000016,0.599999880000024
2024-08-15,한화오션,9,3,3,15,0.7499999375000053,0.2499999791666684
2024-08-16,HD한국조선해양,14,10,2,26,0.5833333090277788,0.41666664930555625
2024-08-16,HD현대마린솔루션,2,1,1,4,0.6666664444445185,0.33333322222225925
2024-08-16,HD현대마린엔진,1,1,0,2,0.499999750000125,0.499999750000125
2024-08-16,HD현대미포,10,2,2,14,0.8333332638888947,0.16666665277777895
2024-08-16,HD현대중공업,20,9,4,33,0.689655148632581,0.3103448168846615
2024-08-16,STX엔진,3,7,0,10,0.299999970000003,0.699999930000007
2024-08-16,삼성중공업,14,6,5,25,0.6999999650000017,0.29999998500000075
2024-08-16,세진중공업,2,1,0,3,0.6666664444445185,0.33333322222225925
2024-08-16,한국카본,0,4,0,4,0.0,0.9999997500000625
2024-08-16,한화엔진,9,2,0,11,0.8181817438016598,0.1818181652892577
2024-08-16,한화오션,20,4,6,30,0.8333332986111125,0.1666666597222225
2024-08-17,HD한국조선해양,4,3,0,7,0.57142848979593,0.4285713673469475
2024-08-17,HD현대마린엔진,1,0,0,1,0.9999990000010001,0.0
2024-08-17,HD현대미포,0,1,0,1,0.0,0.9999990000010001
2024-08-17,HD현대중공업,4,2,0,6,0.6666665555555741,0.33333327777778704
2024-08-17,STX엔진,1,2,0,3,0.33333322222225925,0.6666664444445185
2024-08-17,삼성중공업,1,1,0,2,0.499999750000125,0.499999750000125
2024-08-17,세진중공업,1,1,0,2,0.499999750000125,0.499999750000125
2024-08-17,한화엔진,1,1,0,2,0.499999750000125,0.499999750000125
2024-08-17,한화오션,3,2,0,5,0.599999880000024,0.399999920000016
2024-08-18,HD한국조선해양,10,4,5,19,0.7142856632653098,0.2857142653061239
2024-08-18,HD현대마린솔루션,2,0,0,2,0.99999950000025,0.0
2024-08-18,HD현대마린엔진,0,1,0,1,0.0,0.9999990000010001
2024-08-18,HD현대미포,3,1,6,10,0.7499998125000469,0.24999993750001562
2024-08-18,HD현대중공업,5,1,7,13,0.8333331944444675,0.16666663888889352
2024-08-18,STX엔진,1,0,0,1,0.9999990000010001,0.0
2024-08-18,삼성중공업,8,3,3,14,0.7272726611570308,0.2727272479338866
2024-08-18,한국카본,0,1,0,1,0.0,0.9999990000010001
2024-08-18,한화엔진,2,1,0,3,0.6666664444445185,0.33333322222225925
2024-08-18,한화오션,8,4,5,17,0.6666666111111158,0.3333333055555579
2024-08-19,HD한국조선해양,11,10,9,30,0.5238094988662143,0.47619045351474026
2024-08-19,HD현대마린솔루션,3,0,1,4,0.9999996666667778,0.0
2024-08-19,HD현대미포,7,4,9,20,0.636363578512402,0.3636363305785154
2024-08-19,HD현대중공업,15,10,15,40,0.599999976000001,0.39999998400000064
2024-08-19,STX엔진,2,2,1,5,0.49999987500003124,0.49999987500003124
2024-08-19,삼성중공업,5,6,10,21,0.4545454132231443,0.5454544958677732
2024-08-19,한국카본,2,0,0,2,0.99999950000025,0.0
2024-08-19,한화엔진,7,2,1,10,0.7777776913580343,0.22222219753086697
2024-08-19,한화오션,19,10,7,36,0.655172391200952,0.3448275743162905
2024-08-20,HD한국조선해양,13,7,0,20,0.6499999675000016,0.34999998250000086
2024-08-20,HD현대마린솔루션,6,0,0,6,0.9999998333333611,0.0
2024-08-20,HD현대마린엔진,2,1,0,3,0.6666664444445185,0.33333322222225925
2024-08-20,HD현대미포,8,1,0,9,0.8888887901234679,0.11111109876543349
2024-08-20,HD현대중공업,17,11,5,33,0.6071428354591845,0.3928571288265311
2024-08-20,STX엔진,5,0,1,6,0.99999980000004,0.0
2024-08-20,삼성중공업,15,5,5,25,0.7499999625000018,0.2499999875000006
2024-08-20,세진중공업,0,1,0,1,0.0,0.9999990000010001
2024-08-20,한국카본,1,2,0,3,0.33333322222225925,0.6666664444445185
2024-08-20,한화엔진,17,1,2,20,0.9444443919753115,0.055555552469135974
2024-08-20,한화오션,16,8,7,31,0.66666663888889,0.333333319444445
2024-08-21,HD한국조선해양,16,7,5,28,0.6956521436672981,0.3043478128544429
2024-08-21,HD현대마린솔루션,9,3,0,12,0.7499999375000053,0.2499999791666684
2024-08-21,HD현대마린엔진,9,2,0,11,0.8181817438016598,0.1818181652892577
2024-08-21,HD현대미포,13,4,0,17,0.7647058373702448,0.23529410380622917
2024-08-21,HD현대중공업,31,11,7,49,0.7380952205215424,0.2619047556689344
2024-08-21,STX엔진,2,0,0,2,0.99999950000025,0.0
2024-08-21,삼성중공업,20,7,8,35,0.7407407133058995,0.2592592496570648
2024-08-21,세진중공업,10,1,0,11,0.9090908264462886,0.09090908264462885
2024-08-21,한국카본,10,2,0,12,0.8333332638888947,0.16666665277777895
2024-08-21,한화엔진,15,5,1,21,0.7499999625000018,0.2499999875000006
2024-08-21,한화오션,28,6,10,44,0.8235293875432533,0.17647058304498286
2024-08-22,HD한국조선해양,15,10,6,31,0.599999976000001,0.39999998400000064
2024-08-22,HD현대마린솔루션,5,1,2,8,0.8333331944444675,0.16666663888889352
2024-08-22,HD현대마린엔진,5,1,0,6,0.8333331944444675,0.16666663888889352
2024-08-22,HD현대미포,3,2,3,8,0.599999880000024,0.399999920000016
2024-08-22,HD현대중공업,18,7,4,29,0.7199999712000011,0.27999998880000043
2024-08-22,STX엔진,1,2,0,3,0.33333322222225925,0.6666664444445185
2024-08-22,삼성중공업,15,11,8,34,0.5769230547337286,0.4230769068047343
2024-08-22,세진중공업,1,0,0,1,0.9999990000010001,0.0
2024-08-22,한국카본,2,0,0,2,0.99999950000025,0.0
2024-08-22,한화엔진,7,6,2,15,0.5384614970414233,0.4615384260355057
2024-08-22,한화오션,18,19,11,48,0.48648647333820344,0.5135134996347703
2024-08-23,HD한국조선해양,10,2,3,15,0.8333332638888947,0.16666665277777895
2024-08-23,HD현대마린솔루션,2,1,1,4,0.6666664444445185,0.33333322222225925
2024-08-23,HD현대마린엔진,0,1,0,1,0.0,0.9999990000010001
2024-08-23,HD현대미포,13,2,1,16,0.8666666088888928,0.13333332444444504
2024-08-23,HD현대중공업,20,1,2,23,0.9523809070294805,0.04761904535147403
2024-08-23,STX엔진,0,1,0,1,0.0,0.9999990000010001
2024-08-23,삼성중공업,15,2,3,20,0.8823528892733594,0.11764705190311459
2024-08-23,세진중공업,1,1,0,2,0.499999750000125,0.499999750000125
2024-08-23,한국카본,1,0,0,1,0.9999990000010001,0.0
2024-08-23,한화엔진,12,1,0,13,0.9230768520710114,0.07692307100591762
2024-08-23,한화오션,21,5,6,32,0.8076922766272201,0.1923076849112429
2024-08-24,HD한국조선해양,3,2,1,6,0.599999880000024,0.399999920000016
2024-08-24,HD현대마린솔루션,1,0,0,1,0.9999990000010001,0.0
2024-08-24,HD현대마린엔진,0,1,0,1,0.0,0.9999990000010001
2024-08-24,HD현대미포,5,0,1,6,0.99999980000004,0.0
2024-08-24,HD현대중공업,6,0,1,7,0.9999998333333611,0.0
2024-08-24,삼성중공업,3,3,1,7,0.49999991666668053,0.49999991666668053
2024-08-24,한국카본,0,1,0,1,0.0,0.9999990000010001
2024-08-24,한화엔진,7,1,0,8,0.8749998906250137,0.12499998437500197
2024-08-24,한화오션,5,2,1,8,0.7142856122449125,0.285714244897965
2024-08-25,HD한국조선해양,2,2,1,5,0.49999987500003124,0.49999987500003124
2024-08-25,HD현대마린솔루션,0,2,0,2,0.0,0.99999950000025
2024-08-25,HD현대마린엔진,0,1,0,1,0.0,0.9999990000010001
2024-08-25,HD현대미포,3,3,1,7,0.49999991666668053,0.49999991666668053
2024-08-25,HD현대중공업,3,3,0,6,0.49999991666668053,0.49999991666668053
2024-08-25,STX엔진,0,1,0,1,0.0,0.9999990000010001
2024-08-25,삼성중공업,2,3,1,6,0.399999920000016,0.599999880000024
2024-08-25,세진중공업,1,2,1,4,0.33333322222225925,0.6666664444445185
2024-08-25,한화엔진,5,8,0,13,0.3846153550295881,0.615384568047341
2024-08-25,한화오션,5,4,1,10,0.5555554938271674,0.44444439506173394
2024-08-26,HD한국조선해양,33,8,16,57,0.8048780291493164,0.19512194646044034
2024-08-26,HD현대마린솔루션,1,2,1,4,0.33333322222225925,0.6666664444445185
2024-08-26,HD현대마린엔진,7,3,0,10,0.699999930000007,0.299999970000003
2024-08-26,HD현대미포,8,3,8,19,0.7272726611570308,0.2727272479338866
2024-08-26,HD현대중공업,22,5,17,44,0.8148147846364894,0.18518517832647488
2024-08-26,삼성중공업,13,6,11,30,0.684210490304711,0.31578945706371275
2024-08-26,세진중공업,0,1,0,1,0.0,0.9999990000010001
2024-08-26,한국카본,1,0,0,1,0.9999990000010001,0.0
2024-08-26,한화엔진,9,2,0,11,0.8181817438016598,0.1818181652892577
2024-08-26,한화오션,14,7,8,29,0.6666666349206364,0.3333333174603182
2024-08-27,HD한국조선해양,17,3,3,23,0.8499999575000021,0.14999999250000037
2024-08-27,HD현대마린솔루션,2,1,1,4,0.6666664444445185,0.33333322222225925
2024-08-27,HD현대마린엔진,1,2,0,3,0.33333322222225925,0.6666664444445185
2024-08-27,HD현대미포,5,2,3,10,0.7142856122449125,0.285714244897965
2024-08-27,HD현대중공업,8,3,5,16,0.7272726611570308,0.2727272479338866
2024-08-27,삼성중공업,11,7,6,24,0.6111110771604957,0.3888888672839518
2024-08-27,세진중공업,2,0,0,2,0.99999950000025,0.0
2024-08-27,한국카본,1,1,0,2,0.499999750000125,0.499999750000125
2024-08-27,한화엔진,6,2,0,8,0.7499999062500118,0.24999996875000394
2024-08-27,한화오션,40,5,10,55,0.888888869135803,0.11111110864197538
2024-08-28,HD한국조선해양,11,2,3,16,0.8461537810650938,0.15384614201183525
2024-08-28,HD현대마린솔루션,3,1,0,4,0.7499998125000469,0.24999993750001562
2024-08-28,HD현대마린엔진,1,0,0,1,0.9999990000010001,0.0
2024-08-28,HD현대미포,14,1,3,18,0.9333332711111153,0.06666666222222252
2024-08-28,HD현대중공업,18,1,3,22,0.9473683711911383,0.05263157617728546
2024-08-28,STX엔진,2,0,0,2,0.99999950000025,0.0
2024-08-28,삼성중공업,13,6,4,23,0.684210490304711,0.31578945706371275
2024-08-28,한국카본,1,0,0,1,0.9999990000010001,0.0
2024-08-28,한화엔진,6,2,0,8,0.7499999062500118,0.24999996875000394
2024-08-28,한화오션,20,6,3,29,0.7692307396449716,0.23076922189349144
2024-08-29,HD한국조선해양,14,8,1,23,0.6363636074380178,0.36363634710743875
2024-08-29,HD현대마린솔루션,6,3,0,9,0.6666665925926009,0.33333329629630043
2024-08-29,HD현대마린엔진,2,2,0,4,0.49999987500003124,0.49999987500003124
2024-08-29,HD현대미포,6,4,2,12,0.599999940000006,0.39999996000000404
2024-08-29,HD현대중공업,20,7,8,35,0.7407407133058995,0.2592592496570648
2024-08-29,STX엔진,1,5,1,7,0.16666663888889352,0.8333331944444675
2024-08-29,삼성중공업,8,7,5,20,0.5333332977777802,0.46666663555555765
2024-08-29,세진중공업,0,1,0,1,0.0,0.9999990000010001
2024-08-29,한국카본,6,0,1,7,0.9999998333333611,0.0
2024-08-29,한화엔진,13,6,0,19,0.684210490304711,0.31578945706371275
2024-08-29,한화오션,182,21,4,207,0.8965517197214201,0.10344827535247156
2024-08-30,HD한국조선해양,11,13,4,28,0.4583333142361119,0.5416666440972231
2024-08-30,HD현대마린솔루션,8,2,0,10,0.7999999200000081,0.19999998000000202
2024-08-30,HD현대마린엔진,0,1,0,1,0.0,0.9999990000010001
2024-08-30,HD현대미포,4,4,2,10,0.4999999375000079,0.4999999375000079
2024-08-30,HD현대중공업,13,13,5,31,0.49999998076923147,0.49999998076923147
2024-08-30,STX엔진,2,0,0,2,0.99999950000025,0.0
2024-08-30,삼성중공업,10,9,3,22,0.5263157617728547,0.47368418559556913
2024-08-30,세진중공업,1,1,0,2,0.499999750000125,0.499999750000125
2024-08-30,한국카본,2,1,0,3,0.6666664444445185,0.33333322222225925
2024-08-30,한화엔진,12,5,0,17,0.7058823114186875,0.2941176297577865
2024-08-30,한화오션,16,16,6,38,0.49999998437500054,0.49999998437500054
2024-08-31,HD한국조선해양,3,1,0,4,0.7499998125000469,0.24999993750001562
2024-08-31,HD현대마린솔루션,0,1,0,1,0.0,0.9999990000010001
2024-08-31,HD현대마린엔진,0,1,0,1,0.0,0.9999990000010001
2024-08-31,HD현대미포,1,1,0,2,0.499999750000125,0.499999750000125
2024-08-31,HD현대중공업,2,1,1,4,0.6666664444445185,0.33333322222225925
2024-08-31,삼성중공업,3,1,1,5,0.7499998125000469,0.24999993750001562
2024-08-31,세진중공업,0,1,0,1,0.0,0.9999990000010001
2024-08-31,한화엔진,1,1,0,2,0.499999750000125,0.499999750000125
2024-08-31,한화오션,6,3,2,11,0.6666665925926009,0.33333329629630043
2024-09-01,HD한국조선해양,6,3,3,12,0.6666665925926009,0.33333329629630043
2024-09-01,HD현대마린솔루션,1,3,0,4,0.24999993750001562,0.7499998125000469
2024-09-01,HD현대마린엔진,1,0,0,1,0.9999990000010001,0.0
2024-09-01,HD현대미포,2,0,1,3,0.99999950000025,0.0
2024-09-01,HD현대중공업,7,2,3,12,0.7777776913580343,0.22222219753086697
2024-09-01,STX엔진,1,0,0,1,0.9999990000010001,0.0
2024-09-01,삼성중공업,18,1,1,20,0.9473683711911383,0.05263157617728546
2024-09-01,한화엔진,9,0,0,9,0.9999998888889013,0.0
2024-09-01,한화오션,7,1,4,12,0.8749998906250137,0.12499998437500197
2024-09-02,HD한국조선해양,17,4,4,25,0.8095237709750585,0.19047618140589612
2024-09-02,HD현대마린솔루션,13,3,0,16,0.8124999492187531,0.18749998828125072
2024-09-02,HD현대마린엔진,9,1,0,10,0.8999999100000091,0.09999999000000101
2024-09-02,HD현대미포,17,1,1,19,0.9444443919753115,0.055555552469135974
2024-09-02,HD현대중공업,92,15,11,118,0.8598130760765134,0.1401869145776924
2024-09-02,삼성중공업,27,7,6,40,0.7941176237024229,0.20588234688581333
2024-09-02,세진중공업,9,1,0,10,0.8999999100000091,0.09999999000000101
2024-09-02,한국카본,10,1,0,11,0.9090908264462886,0.09090908264462885
2024-09-02,한화엔진,14,2,2,18,0.8749999453125034,0.12499999218750048
2024-09-02,한화오션,37,7,7,51,0.8409090717975212,0.1590909054752067
2024-09-03,HD한국조선해양,12,4,9,25,0.7499999531250029,0.24999998437500096
2024-09-03,HD현대마린솔루션,5,4,1,10,0.5555554938271674,0.44444439506173394
2024-09-03,HD현대마린엔진,5,2,0,7,0.7142856122449125,0.285714244897965
2024-09-03,HD현대미포,7,1,4,12,0.8749998906250137,0.12499998437500197
2024-09-03,HD현대중공업,19,6,6,31,0.7599999696000012,0.23999999040000036
2024-09-03,STX엔진,2,3,0,5,0.399999920000016,0.599999880000024
2024-09-03,삼성중공업,50,3,7,60,0.9433962086151659,0.056603772516909956
2024-09-03,세진중공업,3,2,0,5,0.599999880000024,0.399999920000016
2024-09-03,한국카본,2,2,0,4,0.49999987500003124,0.49999987500003124
2024-09-03,한화엔진,16,4,5,25,0.799999960000002,0.1999999900000005
2024-09-03,한화오션,57,15,14,86,0.7916666556712965,0.20833333043981486
2024-09-04,HD한국조선해양,14,2,7,23,0.8749999453125034,0.12499999218750048
2024-09-04,HD현대마린솔루션,4,0,0,4,0.9999997500000625,0.0
2024-09-04,HD현대마린엔진,3,1,0,4,0.7499998125000469,0.24999993750001562
2024-09-04,HD현대미포,10,4,4,18,0.7142856632653098,0.2857142653061239
2024-09-04,HD현대중공업,23,4,10,37,0.8518518203017844,0.1481481426611799
2024-09-04,STX엔진,1,0,0,1,0.9999990000010001,0.0
2024-09-04,삼성중공업,14,4,11,29,0.7777777345679036,0.2222222098765439
2024-09-04,한국카본,1,0,0,1,0.9999990000010001,0.0
2024-09-04,한화엔진,23,3,0,26,0.8846153505917173,0.11538461094674572
2024-09-04,한화오션,100,5,16,121,0.9523809433106577,0.047619047165532884
2024-09-05,HD한국조선해양,15,5,9,29,0.7499999625000018,0.2499999875000006
2024-09-05,HD현대마린솔루션,5,0,1,6,0.99999980000004,0.0
2024-09-05,HD현대마린엔진,2,0,1,3,0.99999950000025,0.0
2024-09-05,HD현대미포,10,3,5,18,0.7692307100591762,0.23076921301775286
2024-09-05,HD현대중공업,22,4,16,42,0.8461538136094686,0.15384614792899431
2024-09-05,삼성중공업,15,2,11,28,0.8823528892733594,0.11764705190311459
2024-09-05,세진중공업,0,1,1,2,0.0,0.9999990000010001
2024-09-05,한국카본,0,0,1,1,0.0,0.0
2024-09-05,한화엔진,10,6,0,16,0.6249999609375024,0.37499997656250145
2024-09-05,한화오션,27,6,9,42,0.8181817933884306,0.18181817630854014
2024-09-06,HD한국조선해양,11,6,1,18,0.6470587854671302,0.35294115570934376
2024-09-06,HD현대마린솔루션,5,5,0,10,0.499999950000005,0.499999950000005
2024-09-06,HD현대마린엔진,3,1,0,4,0.7499998125000469,0.24999993750001562
2024-09-06,HD현대미포,10,4,3,17,0.7142856632653098,0.2857142653061239
2024-09-06,HD현대중공업,18,4,4,26,0.8181817809917372,0.18181817355371938
2024-09-06,STX엔진,2,0,0,2,0.99999950000025,0.0
2024-09-06,삼성중공업,16,2,2,20,0.8888888395061756,0.11111110493827195
2024-09-06,한국카본,3,0,0,3,0.9999996666667778,0.0
2024-09-06,한화엔진,9,2,2,13,0.8181817438016598,0.1818181652892577
2024-09-06,한화오션,18,6,4,28,0.7499999687500013,0.24999998958333375
2024-09-07,HD한국조선해양,4,0,1,5,0.9999997500000625,0.0
2024-09-07,HD현대마린솔루션,1,1,0,2,0.499999750000125,0.499999750000125
2024-09-07,HD현대마린엔진,1,0,0,1,0.9999990000010001,0.0
2024-09-07,HD현대미포,2,0,0,2,0.99999950000025,0.0
2024-09-07,HD현대중공업,3,2,0,5,0.599999880000024,0.399999920000016
2024-09-07,STX엔진,0,1,0,1,0.0,0.9999990000010001
2024-09-07,삼성중공업,3,1,1,5,0.7499998125000469,0.24999993750001562
2024-09-07,세진중공업,2,1,0,3,0.6666664444445185,0.33333322222225925
2024-09-07,한국카본,0,1,0,1,0.0,0.9999990000010001
2024-09-07,한화엔진,2,0,0,2,0.99999950000025,0.0
2024-09-07,한화오션,4,0,1,5,0.9999997500000625,0.0
2024-09-08,HD한국조선해양,9,0,0,9,0.9999998888889013,0.0
2024-09-08,HD현대마린솔루션,2,2,0,4,0.49999987500003124,0.49999987500003124
2024-09-08,HD현대마린엔진,1,0,0,1,0.9999990000010001,0.0
2024-09-08,HD현대미포,5,0,0,5,0.99999980000004,0.0
2024-09-08,HD현대중공업,14,1,1,16,0.9333332711111153,0.06666666222222252
2024-09-08,STX엔진,1,1,0,2,0.499999750000125,0.499999750000125
2024-09-08,삼성중공업,4,0,1,5,0.9999997500000625,0.0
2024-09-08,세진중공업,1,1,0,2,0.499999750000125,0.499999750000125
2024-09-08,한국카본,0,1,0,1,0.0,0.9999990000010001
2024-09-08,한화엔진,12,0,0,12,0.9999999166666736,0.0
2024-09-08,한화오션,14,1,0,15,0.9333332711111153,0.06666666222222252
2024-09-09,HD한국조선해양,12,8,4,24,0.5999999700000015,0.399999980000001
2024-09-09,HD현대마린솔루션,10,1,0,11,0.9090908264462886,0.09090908264462885
2024-09-09,HD현대마린엔진,7,0,0,7,0.9999998571428775,0.0
2024-09-09,HD현대미포,6,3,4,13,0.6666665925926009,0.33333329629630043
2024-09-09,HD현대중공업,35,7,9,51,0.833333313492064,0.1666666626984128
2024-09-09,삼성중공업,11,2,8,21,0.8461537810650938,0.15384614201183525
2024-09-09,한국카본,2,0,0,2,0.99999950000025,0.0
2024-09-09,한화엔진,16,1,0,17,0.9411764152249167,0.05882352595155729
2024-09-09,한화오션,23,0,11,34,0.999999956521741,0.0
2024-09-10,HD한국조선해양,12,1,6,19,0.9230768520710114,0.07692307100591762
2024-09-10,HD현대마린솔루션,5,5,0,10,0.499999950000005,0.499999950000005
2024-09-10,HD현대마린엔진,4,3,0,7,0.57142848979593,0.4285713673469475
2024-09-10,HD현대미포,7,1,2,10,0.8749998906250137,0.12499998437500197
2024-09-10,HD현대중공업,25,7,4,36,0.7812499755859383,0.21874999316406274
2024-09-10,STX엔진,0,1,0,1,0.0,0.9999990000010001
2024-09-10,삼성중공업,17,3,8,28,0.8499999575000021,0.14999999250000037
2024-09-10,세진중공업,0,3,0,3,0.0,0.9999996666667778
2024-09-10,한국카본,0,1,0,1,0.0,0.9999990000010001
2024-09-10,한화엔진,13,3,3,19,0.8124999492187531,0.18749998828125072
2024-09-10,한화오션,73,12,18,103,0.8588235193079586,0.14117646892733565
2024-09-11,HD한국조선해양,13,2,8,23,0.8666666088888928,0.13333332444444504
2024-09-11,HD현대마린솔루션,7,1,1,9,0.8749998906250137,0.12499998437500197
2024-09-11,HD현대마린엔진,1,0,0,1,0.9999990000010001,0.0
2024-09-11,HD현대미포,8,1,1,10,0.8888887901234679,0.11111109876543349
2024-09-11,HD현대중공업,21,7,4,32,0.7499999732142867,0.24999999107142887
2024-09-11,STX엔진,1,0,0,1,0.9999990000010001,0.0
2024-09-11,삼성중공업,15,6,7,28,0.7142856802721105,0.28571427210884415
2024-09-11,세진중공업,0,0,1,1,0.0,0.0
2024-09-11,한국카본,10,0,0,10,0.99999990000001,0.0
2024-09-11,한화엔진,7,3,3,13,0.699999930000007,0.299999970000003
2024-09-11,한화오션,82,7,16,105,0.9213483042545134,0.07865168450953164
2024-09-12,HD한국조선해양,38,16,4,58,0.7037036906721539,0.29629629080932796
2024-09-12,HD현대마린솔루션,21,3,0,24,0.8749999635416682,0.12499999479166687
2024-09-12,HD현대마린엔진,19,1,0,20,0.9499999525000024,0.04999999750000012
2024-09-12,HD현대미포,23,2,1,26,0.9199999632000014,0.07999999680000013
2024-09-12,HD현대중공업,43,9,6,58,0.8269230610207104,0.17307691974852077
2024-09-12,삼성중공업,14,5,3,22,0.7368420664819965,0.26315788088642733
2024-09-12,세진중공업,4,0,0,4,0.9999997500000625,0.0
2024-09-12,한국카본,9,1,0,10,0.8999999100000091,0.09999999000000101
2024-09-12,한화엔진,18,2,0,20,0.8999999550000022,0.09999999500000024
2024-09-12,한화오션,106,13,15,134,0.8907562950356614,0.10924369656097734
2024-09-13,HD한국조선해양,8,11,1,20,0.4210526094182837,0.5789473379501401
2024-09-13,HD현대마린솔루션,7,3,0,10,0.699999930000007,0.299999970000003
2024-09-13,HD현대마린엔진,4,3,0,7,0.57142848979593,0.4285713673469475
2024-09-13,HD현대미포,4,5,2,11,0.44444439506173394,0.5555554938271674
2024-09-13,HD현대중공업,11,9,8,28,0.5499999725000013,0.4499999775000011
2024-09-13,STX엔진,0,2,0,2,0.0,0.99999950000025
2024-09-13,삼성중공업,9,5,5,19,0.6428570969387788,0.3571428316326549
2024-09-13,세진중공업,2,1,0,3,0.6666664444445185,0.33333322222225925
2024-09-13,한국카본,2,2,0,4,0.49999987500003124,0.49999987500003124
2024-09-13,한화엔진,13,3,2,18,0.8124999492187531,0.18749998828125072
2024-09-13,한화오션,18,5,9,32,0.7826086616257103,0.21739129489603065
2024-09-14,HD한국조선해양,2,1,1,4,0.6666664444445185,0.33333322222225925
2024-09-14,HD현대마린솔루션,2,0,0,2,0.99999950000025,0.0
2024-09-14,HD현대마린엔진,2,0,0,2,0.99999950000025,0.0
2024-09-14,HD현대미포,1,2,0,3,0.33333322222225925,0.6666664444445185
2024-09-14,HD현대중공업,8,2,1,11,0.7999999200000081,0.19999998000000202
2024-09-14,삼성중공업,2,2,1,5,0.49999987500003124,0.49999987500003124
2024-09-14,세진중공업,0,1,0,1,0.0,0.9999990000010001
2024-09-14,한화엔진,1,1,0,2,0.499999750000125,0.499999750000125
2024-09-14,한화오션,7,2,1,10,0.7777776913580343,0.22222219753086697
2024-09-15,HD한국조선해양,2,3,1,6,0.399999920000016,0.599999880000024
2024-09-15,HD현대마린솔루션,1,0,0,1,0.9999990000010001,0.0
2024-09-15,HD현대마린엔진,1,0,0,1,0.9999990000010001,0.0
2024-09-15,HD현대미포,1,0,0,1,0.9999990000010001,0.0
2024-09-15,HD현대중공업,3,0,1,4,0.9999996666667778,0.0
2024-09-15,STX엔진,0,1,0,1,0.0,0.9999990000010001
2024-09-15,삼성중공업,0,2,1,3,0.0,0.99999950000025
2024-09-15,한화엔진,3,0,0,3,0.9999996666667778,0.0
2024-09-15,한화오션,7,2,1,10,0.7777776913580343,0.22222219753086697
2024-09-16,HD한국조선해양,6,4,0,10,0.599999940000006,0.39999996000000404
2024-09-16,HD현대마린솔루션,4,2,0,6,0.6666665555555741,0.33333327777778704
2024-09-16,HD현대마린엔진,3,2,0,5,0.599999880000024,0.399999920000016
2024-09-16,HD현대미포,5,3,0,8,0.6249999218750099,0.3749999531250059
2024-09-16,HD현대중공업,8,2,0,10,0.7999999200000081,0.19999998000000202
2024-09-16,STX엔진,1,0,0,1,0.9999990000010001,0.0
2024-09-16,삼성중공업,4,5,0,9,0.44444439506173394,0.5555554938271674
2024-09-16,세진중공업,1,1,0,2,0.499999750000125,0.499999750000125
2024-09-16,한국카본,3,1,0,4,0.7499998125000469,0.24999993750001562
2024-09-16,한화엔진,6,4,0,10,0.599999940000006,0.39999996000000404
2024-09-16,한화오션,11,5,0,16,0.6874999570312527,0.3124999804687512
2024-09-17,HD한국조선해양,2,0,2,4,0.99999950000025,0.0
2024-09-17,HD현대중공업,3,0,0,3,0.9999996666667778,0.0
2024-09-17,STX엔진,1,0,0,1,0.9999990000010001,0.0
2024-09-17,삼성중공업,0,0,2,2,0.0,0.0
2024-09-17,세진중공업,1,0,0,1,0.9999990000010001,0.0
2024-09-17,한국카본,2,0,0,2,0.99999950000025,0.0
2024-09-17,한화엔진,2,1,0,3,0.6666664444445185,0.33333322222225925
2024-09-17,한화오션,9,2,1,12,0.8181817438016598,0.1818181652892577
2024-09-18,HD한국조선해양,6,6,3,15,0.4999999583333368,0.4999999583333368
2024-09-18,HD현대마린솔루션,2,0,0,2,0.99999950000025,0.0
2024-09-18,HD현대마린엔진,1,0,0,1,0.9999990000010001,0.0
2024-09-18,HD현대미포,2,0,0,2,0.99999950000025,0.0
2024-09-18,HD현대중공업,10,3,4,17,0.7692307100591762,0.23076921301775286
2024-09-18,삼성중공업,8,4,4,16,0.6666666111111158,0.3333333055555579
2024-09-18,한화엔진,1,1,0,2,0.499999750000125,0.499999750000125
2024-09-18,한화오션,20,4,8,32,0.8333332986111125,0.1666666597222225
2024-09-19,HD한국조선해양,18,13,6,37,0.5806451425598341,0.4193548251821024
2024-09-19,HD현대마린솔루션,9,3,0,12,0.7499999375000053,0.2499999791666684
2024-09-19,HD현대마린엔진,4,2,0,6,0.6666665555555741,0.33333327777778704
2024-09-19,HD현대미포,7,5,1,13,0.5833332847222263,0.41666663194444736
2024-09-19,HD현대중공업,18,7,7,32,0.7199999712000011,0.27999998880000043
2024-09-19,STX엔진,0,1,0,1,0.0,0.9999990000010001
2024-09-19,삼성중공업,23,11,5,39,0.676470568339101,0.32352940224913523
2024-09-19,세진중공업,0,3,0,3,0.0,0.9999996666667778
2024-09-19,한국카본,1,1,0,2,0.499999750000125,0.499999750000125
2024-09-19,한화엔진,14,4,0,18,0.7777777345679036,0.2222222098765439
2024-09-19,한화오션,68,14,10,92,0.829268282569899,0.17073170523497921
2024-09-20,HD한국조선해양,8,12,7,27,0.399999980000001,0.5999999700000015
2024-09-20,HD현대마린솔루션,3,2,0,5,0.599999880000024,0.399999920000016
2024-09-20,HD현대마린엔진,1,1,0,2,0.499999750000125,0.499999750000125
2024-09-20,HD현대미포,11,7,0,18,0.6111110771604957,0.3888888672839518
2024-09-20,HD현대중공업,14,11,6,31,0.5599999776000009,0.4399999824000007
2024-09-20,삼성중공업,10,5,5,20,0.6666666222222252,0.3333333111111126
2024-09-20,세진중공업,0,0,1,1,0.0,0.0
2024-09-20,한화엔진,29,6,1,36,0.8285714048979599,0.1714285665306124
2024-09-20,한화오션,64,12,11,87,0.8421052520775625,0.15789473476454297
2024-09-21,HD한국조선해양,4,2,0,6,0.6666665555555741,0.33333327777778704
2024-09-21,HD현대마린솔루션,1,1,0,2,0.499999750000125,0.499999750000125
2024-09-21,HD현대마린엔진,0,1,0,1,0.0,0.9999990000010001
2024-09-21,HD현대미포,0,1,0,1,0.0,0.9999990000010001
2024-09-21,HD현대중공업,0,2,0,2,0.0,0.99999950000025
2024-09-21,STX엔진,2,0,0,2,0.99999950000025,0.0
2024-09-21,삼성중공업,2,2,0,4,0.49999987500003124,0.49999987500003124
2024-09-21,세진중공업,1,1,0,2,0.499999750000125,0.499999750000125
2024-09-21,한화엔진,5,2,0,7,0.7142856122449125,0.285714244897965
2024-09-21,한화오션,8,2,0,10,0.7999999200000081,0.19999998000000202
2024-09-22,HD한국조선해양,8,3,0,11,0.7272726611570308,0.2727272479338866
2024-09-22,HD현대마린솔루션,9,3,1,13,0.7499999375000053,0.2499999791666684
2024-09-22,HD현대마린엔진,9,2,1,12,0.8181817438016598,0.1818181652892577
2024-09-22,HD현대미포,6,4,0,10,0.599999940000006,0.39999996000000404
2024-09-22,HD현대중공업,11,6,0,17,0.6470587854671302,0.35294115570934376
2024-09-22,STX엔진,2,0,0,2,0.99999950000025,0.0
2024-09-22,삼성중공업,3,5,0,8,0.3749999531250059,0.6249999218750099
2024-09-22,세진중공업,1,1,1,3,0.499999750000125,0.499999750000125
2024-09-22,한화엔진,8,2,0,10,0.7999999200000081,0.19999998000000202
2024-09-22,한화오션,14,3,6,23,0.8235293633218022,0.17647057785467188
2024-09-23,HD한국조선해양,13,7,4,24,0.6499999675000016,0.34999998250000086
2024-09-23,HD현대마린솔루션,10,1,0,11,0.9090908264462886,0.09090908264462885
2024-09-23,HD현대마린엔진,11,1,1,13,0.9166665902777842,0.08333332638888948
2024-09-23,HD현대미포,9,4,2,15,0.6923076390532585,0.3076922840236705
2024-09-23,HD현대중공업,46,12,6,64,0.793103434601665,0.20689654815695607
2024-09-23,STX엔진,0,1,0,1,0.0,0.9999990000010001
2024-09-23,삼성중공업,15,6,7,28,0.7142856802721105,0.28571427210884415
2024-09-23,한국카본,1,0,0,1,0.9999990000010001,0.0
2024-09-23,한화엔진,8,5,1,14,0.615384568047341,0.3846153550295881
2024-09-23,한화오션,41,9,5,55,0.8199999836000004,0.17999999640000008
2024-09-24,HD한국조선해양,24,8,6,38,0.7499999765625008,0.24999999218750027
2024-09-24,HD현대마린솔루션,7,2,1,10,0.7777776913580343,0.22222219753086697
2024-09-24,HD현대마린엔진,23,0,1,24,0.999999956521741,0.0
2024-09-24,HD현대미포,9,3,1,13,0.7499999375000053,0.2499999791666684
2024-09-24,HD현대중공업,30,12,4,46,0.714285697278912,0.2857142789115648
2024-09-24,STX엔진,2,0,0,2,0.99999950000025,0.0
2024-09-24,삼성중공업,14,3,3,20,0.8235293633218022,0.17647057785467188
2024-09-24,세진중공업,0,1,0,1,0.0,0.9999990000010001
2024-09-24,한국카본,1,0,0,1,0.9999990000010001,0.0
2024-09-24,한화엔진,9,0,1,10,0.9999998888889013,0.0
2024-09-24,한화오션,30,3,8,41,0.9090908815427007,0.09090908815427007
2024-09-25,HD한국조선해양,16,3,2,21,0.8421052188365674,0.15789472853185638
2024-09-25,HD현대마린솔루션,1,1,0,2,0.499999750000125,0.499999750000125
2024-09-25,HD현대마린엔진,9,1,0,10,0.8999999100000091,0.09999999000000101
2024-09-25,HD현대미포,16,2,0,18,0.8888888395061756,0.11111110493827195
2024-09-25,HD현대중공업,26,3,3,32,0.8965516932223554,0.10344827229488716
2024-09-25,STX엔진,1,1,0,2,0.499999750000125,0.499999750000125
2024-09-25,삼성중공업,18,1,1,20,0.9473683711911383,0.05263157617728546
2024-09-25,세진중공업,1,0,0,1,0.9999990000010001,0.0
2024-09-25,한국카본,2,0,0,2,0.99999950000025,0.0
2024-09-25,한화엔진,14,1,0,15,0.9333332711111153,0.06666666222222252
2024-09-25,한화오션,59,5,4,68,0.9218749855957034,0.07812499877929689
2024-09-26,HD한국조선해양,18,4,1,23,0.8181817809917372,0.18181817355371938
2024-09-26,HD현대마린솔루션,3,0,0,3,0.9999996666667778,0.0
2024-09-26,HD현대마린엔진,10,0,0,10,0.99999990000001,0.0
2024-09-26,HD현대미포,16,1,1,18,0.9411764152249167,0.05882352595155729
2024-09-26,HD현대중공업,21,3,3,27,0.8749999635416682,0.12499999479166687
2024-09-26,STX엔진,2,1,1,4,0.6666664444445185,0.33333322222225925
2024-09-26,삼성중공업,14,5,3,22,0.7368420664819965,0.26315788088642733
2024-09-26,세진중공업,0,1,0,1,0.0,0.9999990000010001
2024-09-26,한국카본,1,0,0,1,0.9999990000010001,0.0
2024-09-26,한화엔진,12,1,2,15,0.9230768520710114,0.07692307100591762
2024-09-26,한화오션,36,6,5,47,0.8571428367346944,0.1428571394557824
2024-09-27,HD한국조선해양,17,4,5,26,0.8095237709750585,0.19047618140589612
2024-09-27,HD현대마린솔루션,5,0,0,5,0.99999980000004,0.0
2024-09-27,HD현대마린엔진,2,2,0,4,0.49999987500003124,0.49999987500003124
2024-09-27,HD현대미포,4,3,2,9,0.57142848979593,0.4285713673469475
2024-09-27,HD현대중공업,14,2,11,27,0.8749999453125034,0.12499999218750048
2024-09-27,STX엔진,10,2,0,12,0.8333332638888947,0.16666665277777895
2024-09-27,삼성중공업,10,4,12,26,0.7142856632653098,0.2857142653061239
2024-09-27,세진중공업,1,1,0,2,0.499999750000125,0.499999750000125
2024-09-27,한국카본,7,1,0,8,0.8749998906250137,0.12499998437500197
2024-09-27,한화엔진,37,8,0,45,0.8222222039506177,0.1777777738271606
2024-09-27,한화오션,64,7,9,80,0.9014084380083319,0.0985915479071613
2024-09-28,HD현대중공업,1,0,1,2,0.9999990000010001,0.0
2024-09-28,STX엔진,3,2,0,5,0.599999880000024,0.399999920000016
2024-09-28,삼성중공업,1,0,0,1,0.9999990000010001,0.0
2024-09-28,한화엔진,7,2,0,9,0.7777776913580343,0.22222219753086697
2024-09-28,한화오션,8,0,0,8,0.9999998750000157,0.0
2024-09-29,HD한국조선해양,12,2,0,14,0.8571427959183717,0.14285713265306196
2024-09-29,HD현대마린엔진,1,0,0,1,0.9999990000010001,0.0
2024-09-29,HD현대미포,1,0,0,1,0.9999990000010001,0.0
2024-09-29,HD현대중공업,15,3,0,18,0.8333332870370396,0.1666666574074079
2024-09-29,STX엔진,6,3,0,9,0.6666665925926009,0.33333329629630043
2024-09-29,삼성중공업,3,1,0,4,0.7499998125000469,0.24999993750001562
2024-09-29,한화엔진,7,3,0,10,0.699999930000007,0.299999970000003
2024-09-29,한화오션,17,5,1,23,0.7727272376033073,0.2272727169421492
2024-09-30,HD한국조선해양,15,3,10,28,0.8333332870370396,0.1666666574074079
2024-09-30,HD현대마린솔루션,9,4,1,14,0.6923076390532585,0.3076922840236705
2024-09-30,HD현대마린엔진,9,1,0,10,0.8999999100000091,0.09999999000000101
2024-09-30,HD현대미포,4,2,4,10,0.6666665555555741,0.33333327777778704
2024-09-30,HD현대중공업,24,2,12,38,0.9230768875739658,0.07692307396449716
2024-09-30,STX엔진,3,4,1,8,0.4285713673469475,0.57142848979593
2024-09-30,삼성중공업,18,5,7,30,0.7826086616257103,0.21739129489603065
2024-09-30,한국카본,8,1,1,10,0.8888887901234679,0.11111109876543349
2024-09-30,한화엔진,16,11,2,29,0.5925925706447196,0.4074073923182447
2024-09-30,한화오션,39,6,13,58,0.8666666474074078,0.13333333037037046
2024-10-01,HD한국조선해양,5,2,3,10,0.7142856122449125,0.285714244897965
2024-10-01,HD현대마린솔루션,2,2,2,6,0.49999987500003124,0.49999987500003124
2024-10-01,HD현대마린엔진,1,1,0,2,0.499999750000125,0.499999750000125
2024-10-01,HD현대미포,6,2,2,10,0.7499999062500118,0.24999996875000394
2024-10-01,HD현대중공업,6,4,2,12,0.599999940000006,0.39999996000000404
2024-10-01,STX엔진,0,1,0,1,0.0,0.9999990000010001
2024-10-01,삼성중공업,10,3,5,18,0.7692307100591762,0.23076921301775286
2024-10-01,한국카본,1,0,0,1,0.9999990000010001,0.0
2024-10-01,한화엔진,4,0,0,4,0.9999997500000625,0.0
2024-10-01,한화오션,19,3,4,26,0.863636324380167,0.13636363016528952
2024-10-02,HD한국조선해양,12,5,4,21,0.7058823114186875,0.2941176297577865
2024-10-02,HD현대마린솔루션,4,3,2,9,0.57142848979593,0.4285713673469475
2024-10-02,HD현대마린엔진,2,0,1,3,0.99999950000025,0.0
2024-10-02,HD현대미포,12,3,2,17,0.7999999466666703,0.19999998666666757
2024-10-02,HD현대중공업,25,1,5,31,0.9615384245562144,0.03846153698224858
2024-10-02,STX엔진,8,5,0,13,0.615384568047341,0.3846153550295881
2024-10-02,삼성중공업,21,2,7,30,0.9130434385633287,0.08695651795841226
2024-10-02,세진중공업,1,0,0,1,0.9999990000010001,0.0
2024-10-02,한국카본,0,1,0,1,0.0,0.9999990000010001
2024-10-02,한화엔진,23,5,0,28,0.8214285420918378,0.17857142219387778
2024-10-02,한화오션,45,8,15,68,0.8490565877536493,0.15094339337842655
2024-10-03,HD한국조선해양,7,2,1,10,0.7777776913580343,0.22222219753086697
2024-10-03,HD현대마린솔루션,1,1,1,3,0.499999750000125,0.499999750000125
2024-10-03,HD현대미포,2,0,1,3,0.99999950000025,0.0
2024-10-03,HD현대중공업,14,4,3,21,0.7777777345679036,0.2222222098765439
2024-10-03,STX엔진,6,1,0,7,0.857142734693895,0.1428571224489825
2024-10-03,삼성중공업,8,3,8,19,0.7272726611570308,0.2727272479338866
2024-10-03,한국카본,1,0,0,1,0.9999990000010001,0.0
2024-10-03,한화엔진,8,0,1,9,0.9999998750000157,0.0
2024-10-03,한화오션,17,6,7,30,0.7391304026465042,0.2608695538752368
2024-10-04,HD한국조선해양,17,4,3,24,0.8095237709750585,0.19047618140589612
2024-10-04,HD현대마린솔루션,3,4,0,7,0.4285713673469475,0.57142848979593
2024-10-04,HD현대마린엔진,3,4,0,7,0.4285713673469475,0.57142848979593
2024-10-04,HD현대미포,6,3,1,10,0.6666665925926009,0.33333329629630043
2024-10-04,HD현대중공업,23,4,4,31,0.8518518203017844,0.1481481426611799
2024-10-04,STX엔진,5,3,1,9,0.6249999218750099,0.3749999531250059
2024-10-04,삼성중공업,20,4,4,28,0.8333332986111125,0.1666666597222225
2024-10-04,세진중공업,2,3,0,5,0.399999920000016,0.599999880000024
2024-10-04,한국카본,3,2,0,5,0.599999880000024,0.399999920000016
2024-10-04,한화엔진,13,5,1,19,0.7222221820987677,0.27777776234567986
2024-10-04,한화오션,26,9,6,41,0.7428571216326537,0.2571428497959186
2024-10-05,HD한국조선해양,2,1,1,4,0.6666664444445185,0.33333322222225925
2024-10-05,HD현대마린솔루션,0,1,0,1,0.0,0.9999990000010001
2024-10-05,HD현대마린엔진,0,1,0,1,0.0,0.9999990000010001
2024-10-05,HD현대미포,5,1,0,6,0.8333331944444675,0.16666663888889352
2024-10-05,HD현대중공업,8,2,0,10,0.7999999200000081,0.19999998000000202
2024-10-05,STX엔진,0,1,0,1,0.0,0.9999990000010001
2024-10-05,삼성중공업,3,2,1,6,0.599999880000024,0.399999920000016
2024-10-05,세진중공업,0,1,0,1,0.0,0.9999990000010001
2024-10-05,한국카본,1,0,0,1,0.9999990000010001,0.0
2024-10-05,한화엔진,1,2,0,3,0.33333322222225925,0.6666664444445185
2024-10-05,한화오션,4,3,3,10,0.57142848979593,0.4285713673469475
2024-10-06,HD한국조선해양,0,2,1,3,0.0,0.99999950000025
2024-10-06,HD현대마린솔루션,0,1,0,1,0.0,0.9999990000010001
2024-10-06,HD현대마린엔진,0,1,0,1,0.0,0.9999990000010001
2024-10-06,HD현대미포,5,0,1,6,0.99999980000004,0.0
2024-10-06,HD현대중공업,9,1,5,15,0.8999999100000091,0.09999999000000101
2024-10-06,STX엔진,0,2,1,3,0.0,0.99999950000025
2024-10-06,삼성중공업,3,1,3,7,0.7499998125000469,0.24999993750001562
2024-10-06,세진중공업,0,1,0,1,0.0,0.9999990000010001
2024-10-06,한국카본,0,2,0,2,0.0,0.99999950000025
2024-10-06,한화엔진,4,3,3,10,0.57142848979593,0.4285713673469475
2024-10-06,한화오션,8,4,7,19,0.6666666111111158,0.3333333055555579
2024-10-07,HD한국조선해양,15,7,10,32,0.6818181508264477,0.3181818037190089
2024-10-07,HD현대마린솔루션,5,1,1,7,0.8333331944444675,0.16666663888889352
2024-10-07,HD현대마린엔진,1,2,1,4,0.33333322222225925,0.6666664444445185
2024-10-07,HD현대미포,8,5,8,21,0.615384568047341,0.3846153550295881
2024-10-07,HD현대중공업,24,13,9,46,0.6486486311176046,0.35135134185536915
2024-10-07,STX엔진,1,0,1,2,0.9999990000010001,0.0
2024-10-07,삼성중공업,13,12,7,32,0.5199999792000009,0.4799999808000007
2024-10-07,한국카본,1,1,0,2,0.499999750000125,0.499999750000125
2024-10-07,한화엔진,9,6,4,19,0.5999999600000027,0.39999997333333515
2024-10-07,한화오션,26,11,9,46,0.7027026837107383,0.2972972892622354
2024-10-08,HD한국조선해양,55,11,9,75,0.8333333207070709,0.16666666414141418
2024-10-08,HD현대마린솔루션,7,7,0,14,0.49999996428571686,0.49999996428571686
2024-10-08,HD현대마린엔진,6,9,0,15,0.39999997333333515,0.5999999600000027
2024-10-08,HD현대미포,9,10,1,20,0.47368418559556913,0.5263157617728547
2024-10-08,HD현대중공업,24,8,8,40,0.7499999765625008,0.24999999218750027
2024-10-08,STX엔진,2,0,0,2,0.99999950000025,0.0
2024-10-08,삼성중공업,12,1,7,20,0.9230768520710114,0.07692307100591762
2024-10-08,한국카본,1,0,0,1,0.9999990000010001,0.0
2024-10-08,한화엔진,17,2,1,20,0.8947367950138528,0.10526315235457093
2024-10-08,한화오션,34,3,8,45,0.9189188940832732,0.08108107888970058
2024-10-09,HD한국조선해양,18,2,1,21,0.8999999550000022,0.09999999500000024
2024-10-09,HD현대마린솔루션,4,6,0,10,0.39999996000000404,0.599999940000006
2024-10-09,HD현대마린엔진,3,5,0,8,0.3749999531250059,0.6249999218750099
2024-10-09,HD현대미포,9,2,0,11,0.8181817438016598,0.1818181652892577
2024-10-09,HD현대중공업,15,8,2,25,0.6521738846880919,0.34782607183364905
2024-10-09,STX엔진,2,0,0,2,0.99999950000025,0.0
2024-10-09,삼성중공업,6,3,1,10,0.6666665925926009,0.33333329629630043
2024-10-09,세진중공업,1,0,0,1,0.9999990000010001,0.0
2024-10-09,한국카본,2,0,0,2,0.99999950000025,0.0
2024-10-09,한화엔진,15,0,0,15,0.9999999333333378,0.0
2024-10-09,한화오션,19,1,4,24,0.9499999525000024,0.04999999750000012
2024-10-10,HD한국조선해양,24,7,2,33,0.7741935234131121,0.22580644432882438
2024-10-10,HD현대마린솔루션,9,3,0,12,0.7499999375000053,0.2499999791666684
2024-10-10,HD현대마린엔진,7,2,1,10,0.7777776913580343,0.22222219753086697
2024-10-10,HD현대미포,6,2,2,10,0.7499999062500118,0.24999996875000394
2024-10-10,HD현대중공업,64,19,9,92,0.771084328059225,0.22891565989258242
2024-10-10,STX엔진,3,0,0,3,0.9999996666667778,0.0
2024-10-10,삼성중공업,24,9,2,35,0.7272727052341605,0.2727272644628102
2024-10-10,세진중공업,1,0,0,1,0.9999990000010001,0.0
2024-10-10,한국카본,0,0,1,1,0.0,0.0
2024-10-10,한화엔진,40,2,1,43,0.952380929705216,0.0476190464852608
2024-10-10,한화오션,140,12,7,159,0.9210526255193906,0.07894736790166205
2024-10-11,HD한국조선해양,11,5,4,20,0.6874999570312527,0.3124999804687512
2024-10-11,HD현대마린솔루션,1,2,1,4,0.33333322222225925,0.6666664444445185
2024-10-11,HD현대마린엔진,0,1,0,1,0.0,0.9999990000010001
2024-10-11,HD현대미포,5,4,1,10,0.5555554938271674,0.44444439506173394
2024-10-11,HD현대중공업,21,9,5,35,0.6999999766666675,0.2999999900000003
2024-10-11,STX엔진,0,2,0,2,0.0,0.99999950000025
2024-10-11,삼성중공업,11,3,3,17,0.7857142295918408,0.21428569897959293
2024-10-11,한국카본,2,1,0,3,0.6666664444445185,0.33333322222225925
2024-10-11,한화엔진,10,3,1,14,0.7692307100591762,0.23076921301775286
2024-10-11,한화오션,24,7,7,38,0.7741935234131121,0.22580644432882438
2024-10-12,HD한국조선해양,4,0,2,6,0.9999997500000625,0.0
2024-10-12,HD현대마린솔루션,1,0,0,1,0.9999990000010001,0.0
2024-10-12,HD현대마린엔진,1,0,0,1,0.9999990000010001,0.0
2024-10-12,HD현대미포,2,0,1,3,0.99999950000025,0.0
2024-10-12,HD현대중공업,4,1,3,8,0.799999840000032,0.199999960000008
2024-10-12,STX엔진,1,0,0,1,0.9999990000010001,0.0
2024-10-12,삼성중공업,3,0,1,4,0.9999996666667778,0.0
2024-10-12,한화엔진,3,0,0,3,0.9999996666667778,0.0
2024-10-12,한화오션,7,0,3,10,0.9999998571428775,0.0
2024-10-13,HD한국조선해양,3,3,2,8,0.49999991666668053,0.49999991666668053
2024-10-13,HD현대마린엔진,1,0,0,1,0.9999990000010001,0.0
2024-10-13,HD현대미포,1,0,2,3,0.9999990000010001,0.0
2024-10-13,HD현대중공업,8,0,2,10,0.9999998750000157,0.0
2024-10-13,STX엔진,1,0,0,1,0.9999990000010001,0.0
2024-10-13,삼성중공업,9,1,1,11,0.8999999100000091,0.09999999000000101
2024-10-13,한화엔진,8,2,1,11,0.7999999200000081,0.19999998000000202
2024-10-13,한화오션,11,1,4,16,0.9166665902777842,0.08333332638888948
2024-10-14,HD한국조선해양,15,7,5,27,0.6818181508264477,0.3181818037190089
2024-10-14,HD현대마린솔루션,5,3,0,8,0.6249999218750099,0.3749999531250059
2024-10-14,HD현대마린엔진,3,1,0,4,0.7499998125000469,0.24999993750001562
2024-10-14,HD현대미포,6,3,3,12,0.6666665925926009,0.33333329629630043
2024-10-14,HD현대중공업,19,4,8,31,0.8260869206049165,0.17391303591682453
2024-10-14,STX엔진,1,2,0,3,0.33333322222225925,0.6666664444445185
2024-10-14,삼성중공업,13,5,5,23,0.7222221820987677,0.27777776234567986
2024-10-14,세진중공업,0,1,0,1,0.0,0.9999990000010001
2024-10-14,한국카본,10,0,0,10,0.99999990000001,0.0
2024-10-14,한화엔진,13,5,0,18,0.7222221820987677,0.27777776234567986
2024-10-14,한화오션,35,11,7,53,0.7608695486767489,0.23913042958412112
2024-10-15,HD한국조선해양,21,10,2,33,0.677419332986473,0.3225806347554634
2024-10-15,HD현대마린솔루션,8,1,1,10,0.8888887901234679,0.11111109876543349
2024-10-15,HD현대마린엔진,6,3,0,9,0.6666665925926009,0.33333329629630043
2024-10-15,HD현대미포,7,7,1,15,0.49999996428571686,0.49999996428571686
2024-10-15,HD현대중공업,54,14,11,79,0.7941176353806231,0.20588234991349486
2024-10-15,STX엔진,6,2,0,8,0.7499999062500118,0.24999996875000394
2024-10-15,삼성중공업,29,11,3,43,0.7249999818750005,0.2749999931250002
2024-10-15,세진중공업,0,2,0,2,0.0,0.99999950000025
2024-10-15,한국카본,3,1,0,4,0.7499998125000469,0.24999993750001562
2024-10-15,한화엔진,14,7,1,22,0.6666666349206364,0.3333333174603182
2024-10-15,한화오션,138,25,35,198,0.8466257616771425,0.15337423218788815
2024-10-16,HD한국조선해양,25,4,7,36,0.8620689357907263,0.13793102972651622
2024-10-16,HD현대마린솔루션,15,3,3,21,0.8333332870370396,0.1666666574074079
2024-10-16,HD현대마린엔진,1,1,1,3,0.499999750000125,0.499999750000125
2024-10-16,HD현대미포,7,1,1,9,0.8749998906250137,0.12499998437500197
2024-10-16,HD현대중공업,31,7,9,47,0.8157894522160671,0.18421052146814418
2024-10-16,STX엔진,3,1,3,7,0.7499998125000469,0.24999993750001562
2024-10-16,삼성중공업,27,4,4,35,0.8709677138397511,0.12903225390218534
2024-10-16,세진중공업,1,0,0,1,0.9999990000010001,0.0
2024-10-16,한국카본,1,0,0,1,0.9999990000010001,0.0
2024-10-16,한화엔진,13,2,3,18,0.8666666088888928,0.13333332444444504
2024-10-16,한화오션,99,5,25,129,0.9519230677699705,0.048076922614644975
2024-10-17,HD한국조선해양,22,1,1,24,0.9565216975425348,0.04347825897920613
2024-10-17,HD현대마린솔루션,7,1,2,10,0.8749998906250137,0.12499998437500197
2024-10-17,HD현대마린엔진,2,2,0,4,0.49999987500003124,0.49999987500003124
2024-10-17,HD현대미포,10,0,2,12,0.99999990000001,0.0
2024-10-17,HD현대중공업,32,2,3,37,0.9411764429065753,0.05882352768166096
2024-10-17,STX엔진,2,1,1,4,0.6666664444445185,0.33333322222225925
2024-10-17,삼성중공업,19,2,3,24,0.9047618616780065,0.09523809070294806
2024-10-17,한국카본,2,1,0,3,0.6666664444445185,0.33333322222225925
2024-10-17,한화엔진,11,2,0,13,0.8461537810650938,0.15384614201183525
2024-10-17,한화오션,40,6,11,57,0.8695651984877131,0.13043477977315696
2024-10-18,HD한국조선해양,19,3,3,25,0.863636324380167,0.13636363016528952
2024-10-18,HD현대마린솔루션,2,2,1,5,0.49999987500003124,0.49999987500003124
2024-10-18,HD현대미포,4,2,0,6,0.6666665555555741,0.33333327777778704
2024-10-18,HD현대중공업,18,4,2,24,0.8181817809917372,0.18181817355371938
2024-10-18,STX엔진,2,0,0,2,0.99999950000025,0.0
2024-10-18,삼성중공업,12,3,5,20,0.7999999466666703,0.19999998666666757
2024-10-18,한국카본,7,2,0,9,0.7777776913580343,0.22222219753086697
2024-10-18,한화엔진,6,2,1,9,0.7499999062500118,0.24999996875000394
2024-10-18,한화오션,34,9,5,48,0.7906976560302871,0.20930232071389954
2024-10-19,HD한국조선해양,6,3,1,10,0.6666665925926009,0.33333329629630043
2024-10-19,HD현대마린솔루션,3,1,0,4,0.7499998125000469,0.24999993750001562
2024-10-19,HD현대마린엔진,0,1,0,1,0.0,0.9999990000010001
2024-10-19,HD현대미포,1,3,0,4,0.24999993750001562,0.7499998125000469
2024-10-19,HD현대중공업,5,3,2,10,0.6249999218750099,0.3749999531250059
2024-10-19,STX엔진,1,1,0,2,0.499999750000125,0.499999750000125
2024-10-19,삼성중공업,4,4,2,10,0.4999999375000079,0.4999999375000079
2024-10-19,세진중공업,2,0,0,2,0.99999950000025,0.0
2024-10-19,한국카본,2,2,0,4,0.49999987500003124,0.49999987500003124
2024-10-19,한화엔진,5,2,0,7,0.7142856122449125,0.285714244897965
2024-10-19,한화오션,13,4,3,20,0.7647058373702448,0.23529410380622917
2024-10-20,HD한국조선해양,6,2,2,10,0.7499999062500118,0.24999996875000394
2024-10-20,HD현대마린솔루션,0,0,1,1,0.0,0.0
2024-10-20,HD현대미포,1,1,0,2,0.499999750000125,0.499999750000125
2024-10-20,HD현대중공업,8,3,0,11,0.7272726611570308,0.2727272479338866
2024-10-20,STX엔진,0,1,1,2,0.0,0.9999990000010001
2024-10-20,삼성중공업,8,3,0,11,0.7272726611570308,0.2727272479338866
2024-10-20,한국카본,2,1,0,3,0.6666664444445185,0.33333322222225925
2024-10-20,한화엔진,1,1,0,2,0.499999750000125,0.499999750000125
2024-10-20,한화오션,16,2,11,29,0.8888888395061756,0.11111110493827195
2024-10-21,HD한국조선해양,12,3,3,18,0.7999999466666703,0.19999998666666757
2024-10-21,HD현대마린솔루션,3,3,1,7,0.49999991666668053,0.49999991666668053
2024-10-21,HD현대마린엔진,2,0,2,4,0.99999950000025,0.0
2024-10-21,HD현대미포,6,0,4,10,0.9999998333333611,0.0
2024-10-21,HD현대중공업,16,1,4,21,0.9411764152249167,0.05882352595155729
2024-10-21,STX엔진,0,1,0,1,0.0,0.9999990000010001
2024-10-21,삼성중공업,10,0,0,10,0.99999990000001,0.0
2024-10-21,한국카본,3,1,0,4,0.7499998125000469,0.24999993750001562
2024-10-21,한화엔진,8,10,3,21,0.4444444197530878,0.5555555246913597
2024-10-21,한화오션,36,7,11,54,0.8372092828555981,0.16279069388858852
2024-10-22,HD한국조선해양,15,0,6,21,0.9999999333333378,0.0
2024-10-22,HD현대마린솔루션,5,1,2,8,0.8333331944444675,0.16666663888889352
2024-10-22,HD현대마린엔진,3,0,0,3,0.9999996666667778,0.0
2024-10-22,HD현대미포,3,0,3,6,0.9999996666667778,0.0
2024-10-22,HD현대중공업,21,5,6,32,0.8076922766272201,0.1923076849112429
2024-10-22,STX엔진,1,0,0,1,0.9999990000010001,0.0
2024-10-22,삼성중공업,28,5,3,36,0.8484848227731873,0.15151514692378343
2024-10-22,한국카본,6,0,0,6,0.9999998333333611,0.0
2024-10-22,한화엔진,19,1,1,21,0.9499999525000024,0.04999999750000012
2024-10-22,한화오션,31,4,7,42,0.885714260408164,0.11428571102040827
2024-10-23,HD한국조선해양,11,8,0,19,0.5789473379501401,0.4210526094182837
2024-10-23,HD현대마린솔루션,12,19,3,34,0.38709676170655605,0.6129032060353804
2024-10-23,HD현대마린엔진,13,7,0,20,0.6499999675000016,0.34999998250000086
2024-10-23,HD현대미포,10,2,0,12,0.8333332638888947,0.16666665277777895
2024-10-23,HD현대중공업,18,5,4,27,0.7826086616257103,0.21739129489603065
2024-10-23,STX엔진,0,1,0,1,0.0,0.9999990000010001
2024-10-23,삼성중공업,22,10,2,34,0.6874999785156257,0.3124999902343753
2024-10-23,세진중공업,0,1,1,2,0.0,0.9999990000010001
2024-10-23,한국카본,3,1,0,4,0.7499998125000469,0.24999993750001562
2024-10-23,한화엔진,16,3,0,19,0.8421052188365674,0.15789472853185638
2024-10-23,한화오션,20,9,6,35,0.689655148632581,0.3103448168846615
2024-10-24,HD한국조선해양,13,5,1,19,0.7222221820987677,0.27777776234567986
2024-10-24,HD현대마린솔루션,13,8,7,28,0.6190475895691624,0.38095236281179223
2024-10-24,HD현대마린엔진,3,5,0,8,0.3749999531250059,0.6249999218750099
2024-10-24,HD현대미포,6,0,1,7,0.9999998333333611,0.0
2024-10-24,HD현대중공업,18,4,2,24,0.8181817809917372,0.18181817355371938
2024-10-24,STX엔진,1,1,0,2,0.499999750000125,0.499999750000125
2024-10-24,삼성중공업,14,6,2,22,0.6999999650000017,0.29999998500000075
2024-10-24,세진중공업,0,1,0,1,0.0,0.9999990000010001
2024-10-24,한국카본,1,1,0,2,0.499999750000125,0.499999750000125
2024-10-24,한화엔진,7,2,1,10,0.7777776913580343,0.22222219753086697
2024-10-24,한화오션,23,4,6,33,0.8518518203017844,0.1481481426611799
2024-10-25,HD한국조선해양,12,6,1,19,0.6666666296296316,0.3333333148148158
2024-10-25,HD현대마린솔루션,10,3,1,14,0.7692307100591762,0.23076921301775286
2024-10-25,HD현대마린엔진,3,2,0,5,0.599999880000024,0.399999920000016
2024-10-25,HD현대미포,6,4,0,10,0.599999940000006,0.39999996000000404
2024-10-25,HD현대중공업,16,3,2,21,0.8421052188365674,0.15789472853185638
2024-10-25,STX엔진,2,1,0,3,0.6666664444445185,0.33333322222225925
2024-10-25,삼성중공업,23,11,2,36,0.676470568339101,0.32352940224913523
2024-10-25,세진중공업,3,2,0,5,0.599999880000024,0.399999920000016
2024-10-25,한국카본,6,1,0,7,0.857142734693895,0.1428571224489825
2024-10-25,한화엔진,11,4,3,18,0.7333332844444478,0.2666666488888901
2024-10-25,한화오션,33,8,6,47,0.8048780291493164,0.19512194646044034
2024-10-26,HD한국조선해양,3,4,3,10,0.4285713673469475,0.57142848979593
2024-10-26,HD현대마린솔루션,3,0,0,3,0.9999996666667778,0.0
2024-10-26,HD현대마린엔진,1,0,0,1,0.9999990000010001,0.0
2024-10-26,HD현대미포,0,0,1,1,0.0,0.0
2024-10-26,HD현대중공업,3,2,0,5,0.599999880000024,0.399999920000016
2024-10-26,삼성중공업,4,1,1,6,0.799999840000032,0.199999960000008
2024-10-26,세진중공업,1,0,0,1,0.9999990000010001,0.0
2024-10-26,한국카본,0,0,1,1,0.0,0.0
2024-10-26,한화엔진,7,0,1,8,0.9999998571428775,0.0
2024-10-26,한화오션,8,4,3,15,0.6666666111111158,0.3333333055555579
2024-10-27,HD한국조선해양,5,5,1,11,0.499999950000005,0.499999950000005
2024-10-27,HD현대미포,3,0,0,3,0.9999996666667778,0.0
2024-10-27,HD현대중공업,2,1,1,4,0.6666664444445185,0.33333322222225925
2024-10-27,STX엔진,0,1,0,1,0.0,0.9999990000010001
2024-10-27,삼성중공업,13,4,2,19,0.7647058373702448,0.23529410380622917
2024-10-27,한화엔진,4,3,0,7,0.57142848979593,0.4285713673469475
2024-10-27,한화오션,9,4,1,14,0.6923076390532585,0.3076922840236705
2024-10-28,HD한국조선해양,13,14,2,29,0.48148146364883465,0.5185184993141296
2024-10-28,HD현대마린솔루션,4,3,1,8,0.57142848979593,0.4285713673469475
2024-10-28,HD현대마린엔진,4,3,1,8,0.57142848979593,0.4285713673469475
2024-10-28,HD현대미포,12,4,0,16,0.7499999531250029,0.24999998437500096
2024-10-28,HD현대중공업,17,9,4,30,0.6538461286982258,0.3461538328402372
2024-10-28,삼성중공업,24,14,5,43,0.6315789307479229,0.36842104293628836
2024-10-28,한국카본,1,0,0,1,0.9999990000010001,0.0
2024-10-28,한화엔진,17,7,4,28,0.7083333038194456,0.2916666545138894
2024-10-28,한화오션,23,16,8,47,0.5897435746219597,0.41025639973701544
2024-10-29,HD한국조선해양,11,4,6,21,0.7333332844444478,0.2666666488888901
2024-10-29,HD현대마린솔루션,8,7,1,16,0.5333332977777802,0.46666663555555765
2024-10-29,HD현대마린엔진,1,2,0,3,0.33333322222225925,0.6666664444445185
2024-10-29,HD현대미포,14,2,2,18,0.8749999453125034,0.12499999218750048
2024-10-29,HD현대중공업,12,1,3,16,0.9230768520710114,0.07692307100591762
2024-10-29,STX엔진,1,2,1,4,0.33333322222225925,0.6666664444445185
2024-10-29,삼성중공업,16,5,3,24,0.7619047256235845,0.23809522675737013
2024-10-29,세진중공업,0,1,0,1,0.0,0.9999990000010001
2024-10-29,한국카본,2,3,0,5,0.399999920000016,0.599999880000024
2024-10-29,한화엔진,9,1,3,13,0.8999999100000091,0.09999999000000101
2024-10-29,한화오션,38,27,29,94,0.584615375621302,0.41538460899408297
2024-10-30,HD한국조선해양,17,7,3,27,0.7083333038194456,0.2916666545138894
2024-10-30,HD현대마린솔루션,2,3,1,6,0.399999920000016,0.599999880000024
2024-10-30,HD현대마린엔진,4,1,0,5,0.799999840000032,0.199999960000008
2024-10-30,HD현대미포,6,3,0,9,0.6666665925926009,0.33333329629630043
2024-10-30,HD현대중공업,20,6,1,27,0.7692307396449716,0.23076922189349144
2024-10-30,STX엔진,2,0,1,3,0.99999950000025,0.0
2024-10-30,삼성중공업,8,9,4,21,0.47058820761245834,0.5294117335640156
2024-10-30,한국카본,1,0,0,1,0.9999990000010001,0.0
2024-10-30,한화엔진,10,3,5,18,0.7692307100591762,0.23076921301775286
2024-10-30,한화오션,47,19,10,76,0.7121212013314969,0.28787878351698815
2024-10-31,HD한국조선해양,27,46,4,77,0.3698630086320136,0.6301369776693565
2024-10-31,HD현대마린솔루션,20,19,4,43,0.5128204996712693,0.4871794746877058
2024-10-31,HD현대마린엔진,12,23,0,35,0.3428571330612248,0.6571428383673475
2024-10-31,HD현대미포,25,21,2,48,0.5434782490548207,0.4565217292060494
2024-10-31,HD현대중공업,42,27,4,73,0.608695643352237,0.39130434215500953
2024-10-31,STX엔진,3,1,0,4,0.7499998125000469,0.24999993750001562
2024-10-31,삼성중공업,15,8,3,26,0.6521738846880919,0.34782607183364905
2024-10-31,한화엔진,19,3,0,22,0.863636324380167,0.13636363016528952
2024-10-31,한화오션,27,14,12,53,0.6585365693039862,0.3414634063057706
2024-11-01,HD한국조선해양,17,12,11,40,0.5862068763376939,0.41379308917954866
2024-11-01,HD현대마린솔루션,11,4,11,26,0.7333332844444478,0.2666666488888901
2024-11-01,HD현대마린엔진,7,3,10,20,0.699999930000007,0.299999970000003
2024-11-01,HD현대미포,9,10,3,22,0.47368418559556913,0.5263157617728547
2024-11-01,HD현대중공업,19,12,7,38,0.6129032060353804,0.38709676170655605
2024-11-01,STX엔진,1,1,0,2,0.499999750000125,0.499999750000125
2024-11-01,삼성중공업,17,6,4,27,0.7391304026465042,0.2608695538752368
2024-11-01,한국카본,1,0,1,2,0.9999990000010001,0.0
2024-11-01,한화엔진,11,7,0,18,0.6111110771604957,0.3888888672839518
2024-11-01,한화오션,24,10,7,41,0.7058823321799315,0.2941176384083048
2024-11-02,HD한국조선해양,3,5,0,8,0.3749999531250059,0.6249999218750099
2024-11-02,HD현대마린솔루션,1,3,0,4,0.24999993750001562,0.7499998125000469
2024-11-02,HD현대마린엔진,1,2,0,3,0.33333322222225925,0.6666664444445185
2024-11-02,HD현대미포,1,2,0,3,0.33333322222225925,0.6666664444445185
2024-11-02,HD현대중공업,3,2,0,5,0.599999880000024,0.399999920000016
2024-11-02,STX엔진,0,1,0,1,0.0,0.9999990000010001
2024-11-02,삼성중공업,3,2,0,5,0.599999880000024,0.399999920000016
2024-11-02,한국카본,0,1,0,1,0.0,0.9999990000010001
2024-11-02,한화엔진,3,4,0,7,0.4285713673469475,0.57142848979593
2024-11-02,한화오션,6,4,2,12,0.599999940000006,0.39999996000000404
2024-11-03,HD한국조선해양,4,3,3,10,0.57142848979593,0.4285713673469475
2024-11-03,HD현대마린솔루션,3,0,3,6,0.9999996666667778,0.0
2024-11-03,HD현대마린엔진,1,0,3,4,0.9999990000010001,0.0
2024-11-03,HD현대미포,5,2,1,8,0.7142856122449125,0.285714244897965
2024-11-03,HD현대중공업,11,5,3,19,0.6874999570312527,0.3124999804687512
2024-11-03,STX엔진,0,1,0,1,0.0,0.9999990000010001
2024-11-03,삼성중공업,8,4,1,13,0.6666666111111158,0.3333333055555579
2024-11-03,한화엔진,1,1,1,3,0.499999750000125,0.499999750000125
2024-11-03,한화오션,9,6,2,17,0.5999999600000027,0.39999997333333515
2024-11-04,HD한국조선해양,12,8,3,23,0.5999999700000015,0.399999980000001
2024-11-04,HD현대마린솔루션,5,3,2,10,0.6249999218750099,0.3749999531250059
2024-11-04,HD현대마린엔진,5,2,0,7,0.7142856122449125,0.285714244897965
2024-11-04,HD현대미포,12,5,0,17,0.7058823114186875,0.2941176297577865
2024-11-04,HD현대중공업,38,9,4,51,0.8085106210955187,0.19148935762788602
2024-11-04,STX엔진,5,3,0,8,0.6249999218750099,0.3749999531250059
2024-11-04,삼성중공업,20,4,4,28,0.8333332986111125,0.1666666597222225
2024-11-04,세진중공업,4,2,0,6,0.6666665555555741,0.33333327777778704
2024-11-04,한국카본,9,1,0,10,0.8999999100000091,0.09999999000000101
2024-11-04,한화엔진,5,3,2,10,0.6249999218750099,0.3749999531250059
2024-11-04,한화오션,24,5,4,33,0.8275861783590973,0.17241378715814526
2024-11-05,HD한국조선해양,12,5,3,20,0.7058823114186875,0.2941176297577865
2024-11-05,HD현대마린솔루션,6,1,0,7,0.857142734693895,0.1428571224489825
2024-11-05,HD현대마린엔진,2,0,1,3,0.99999950000025,0.0
2024-11-05,HD현대미포,6,3,1,10,0.6666665925926009,0.33333329629630043
2024-11-05,HD현대중공업,28,4,6,38,0.874999972656251,0.12499999609375013
2024-11-05,STX엔진,1,1,0,2,0.499999750000125,0.499999750000125
2024-11-05,삼성중공업,12,5,3,20,0.7058823114186875,0.2941176297577865
2024-11-05,세진중공업,0,1,0,1,0.0,0.9999990000010001
2024-11-05,한국카본,7,0,0,7,0.9999998571428775,0.0
2024-11-05,한화엔진,12,3,0,15,0.7999999466666703,0.19999998666666757
2024-11-05,한화오션,20,10,4,34,0.6666666444444451,0.33333332222222256
2024-11-06,HD한국조선해양,7,3,11,21,0.699999930000007,0.299999970000003
2024-11-06,HD현대마린솔루션,5,2,1,8,0.7142856122449125,0.285714244897965
2024-11-06,HD현대마린엔진,0,3,0,3,0.0,0.9999996666667778
2024-11-06,HD현대미포,5,2,3,10,0.7142856122449125,0.285714244897965
2024-11-06,HD현대중공업,23,5,12,40,0.8214285420918378,0.17857142219387778
2024-11-06,STX엔진,0,2,1,3,0.0,0.99999950000025
2024-11-06,삼성중공업,15,4,10,29,0.7894736426592819,0.21052630470914185
2024-11-06,세진중공업,0,1,0,1,0.0,0.9999990000010001
2024-11-06,한국카본,1,3,0,4,0.24999993750001562,0.7499998125000469
2024-11-06,한화엔진,9,3,3,15,0.7499999375000053,0.2499999791666684
2024-11-06,한화오션,17,4,14,35,0.8095237709750585,0.19047618140589612
2024-11-07,HD한국조선해양,34,26,10,70,0.5666666572222224,0.43333332611111125
2024-11-07,HD현대마린솔루션,16,11,4,31,0.5925925706447196,0.4074073923182447
2024-11-07,HD현대마린엔진,12,5,1,18,0.7058823114186875,0.2941176297577865
2024-11-07,HD현대미포,22,17,3,42,0.5641025496383962,0.4358974247205789
2024-11-07,HD현대중공업,94,79,23,196,0.5433525980153029,0.4566473962043503
2024-11-07,STX엔진,5,5,0,10,0.499999950000005,0.499999950000005
2024-11-07,삼성중공업,38,49,12,99,0.4367816041749241,0.5632183843308232
2024-11-07,세진중공업,7,3,0,10,0.699999930000007,0.299999970000003
2024-11-07,한국카본,7,2,1,10,0.7777776913580343,0.22222219753086697
2024-11-07,한화엔진,15,10,3,28,0.599999976000001,0.39999998400000064
2024-11-07,한화오션,74,71,20,165,0.5103448240665874,0.4896551690368609
2024-11-08,HD한국조선해양,22,8,7,37,0.7333333088888897,0.26666665777777804
2024-11-08,HD현대마린솔루션,7,1,3,11,0.8749998906250137,0.12499998437500197
2024-11-08,HD현대마린엔진,3,0,0,3,0.9999996666667778,0.0
2024-11-08,HD현대미포,12,2,3,17,0.8571427959183717,0.14285713265306196
2024-11-08,HD현대중공업,44,13,8,65,0.7719298110187752,0.2280701714373654
2024-11-08,삼성중공업,25,6,4,35,0.8064515868886585,0.19354838085327802
2024-11-08,세진중공업,2,0,0,2,0.99999950000025,0.0
2024-11-08,한국카본,3,0,0,3,0.9999996666667778,0.0
2024-11-08,한화엔진,9,2,1,12,0.8181817438016598,0.1818181652892577
2024-11-08,한화오션,56,16,8,80,0.7777777669753089,0.2222222191358025
2024-11-09,HD한국조선해양,9,1,0,10,0.8999999100000091,0.09999999000000101
2024-11-09,HD현대마린솔루션,1,0,1,2,0.9999990000010001,0.0
2024-11-09,HD현대마린엔진,1,0,0,1,0.9999990000010001,0.0
2024-11-09,HD현대미포,3,0,0,3,0.9999996666667778,0.0
2024-11-09,HD현대중공업,10,7,1,18,0.588235259515573,0.4117646816609011
2024-11-09,삼성중공업,2,2,2,6,0.49999987500003124,0.49999987500003124
2024-11-09,한국카본,1,0,1,2,0.9999990000010001,0.0
2024-11-09,한화엔진,4,1,2,7,0.799999840000032,0.199999960000008
2024-11-09,한화오션,11,7,4,22,0.6111110771604957,0.3888888672839518
2024-11-10,HD한국조선해양,11,5,4,20,0.6874999570312527,0.3124999804687512
2024-11-10,HD현대미포,3,2,2,7,0.599999880000024,0.399999920000016
2024-11-10,HD현대중공업,13,4,6,23,0.7647058373702448,0.23529410380622917
2024-11-10,삼성중공업,3,3,2,8,0.49999991666668053,0.49999991666668053
2024-11-10,세진중공업,0,1,0,1,0.0,0.9999990000010001
2024-11-10,한화엔진,7,2,2,11,0.7777776913580343,0.22222219753086697
2024-11-10,한화오션,15,6,14,35,0.7142856802721105,0.28571427210884415
2024-11-11,HD한국조선해양,27,5,1,33,0.8437499736328133,0.15624999511718765
2024-11-11,HD현대마린솔루션,3,1,0,4,0.7499998125000469,0.24999993750001562
2024-11-11,HD현대마린엔진,3,2,0,5,0.599999880000024,0.399999920000016
2024-11-11,HD현대미포,13,8,2,23,0.6190475895691624,0.38095236281179223
2024-11-11,HD현대중공업,24,8,10,42,0.7499999765625008,0.24999999218750027
2024-11-11,STX엔진,8,1,1,10,0.8888887901234679,0.11111109876543349
2024-11-11,삼성중공업,20,12,16,48,0.6249999804687506,0.3749999882812504
2024-11-11,세진중공업,0,2,0,2,0.0,0.99999950000025
2024-11-11,한국카본,1,2,0,3,0.33333322222225925,0.6666664444445185
2024-11-11,한화엔진,27,7,3,37,0.7941176237024229,0.20588234688581333
2024-11-11,한화오션,73,21,28,122,0.7765957364191943,0.22340425294250796
2024-11-12,HD한국조선해양,20,6,3,29,0.7692307396449716,0.23076922189349144
2024-11-12,HD현대마린솔루션,2,2,2,6,0.49999987500003124,0.49999987500003124
2024-11-12,HD현대마린엔진,1,1,0,2,0.499999750000125,0.499999750000125
2024-11-12,HD현대미포,4,5,7,16,0.44444439506173394,0.5555554938271674
2024-11-12,HD현대중공업,66,12,16,94,0.8461538353057201,0.1538461518737673
2024-11-12,STX엔진,6,2,0,8,0.7499999062500118,0.24999996875000394
2024-11-12,삼성중공업,13,3,17,33,0.8124999492187531,0.18749998828125072
2024-11-12,세진중공업,0,1,0,1,0.0,0.9999990000010001
2024-11-12,한국카본,1,1,0,2,0.499999750000125,0.499999750000125
2024-11-12,한화엔진,13,1,2,16,0.9285713622449028,0.07142856632653098
2024-11-12,한화오션,96,24,25,145,0.7999999933333334,0.19999999833333335
2024-11-13,HD한국조선해양,22,6,5,33,0.7857142576530622,0.21428570663265334
2024-11-13,HD현대마린솔루션,0,1,1,2,0.0,0.9999990000010001
2024-11-13,HD현대미포,4,0,4,8,0.9999997500000625,0.0
2024-11-13,HD현대중공업,32,7,12,51,0.8205127994740309,0.17948717488494426
2024-11-13,STX엔진,2,0,0,2,0.99999950000025,0.0
2024-11-13,삼성중공업,13,6,12,31,0.684210490304711,0.31578945706371275
2024-11-13,한국카본,2,0,0,2,0.99999950000025,0.0
2024-11-13,한화엔진,9,8,3,20,0.5294117335640156,0.47058820761245834
2024-11-13,한화오션,42,16,24,82,0.7241379185493463,0.2758620642092748
2024-11-14,HD한국조선해양,35,7,7,49,0.833333313492064,0.1666666626984128
2024-11-14,HD현대마린솔루션,4,4,2,10,0.4999999375000079,0.4999999375000079
2024-11-14,HD현대마린엔진,0,3,2,5,0.0,0.9999996666667778
2024-11-14,HD현대미포,5,6,4,15,0.4545454132231443,0.5454544958677732
2024-11-14,HD현대중공업,113,23,8,144,0.8308823468317474,0.16911764581531144
2024-11-14,STX엔진,1,1,0,2,0.499999750000125,0.499999750000125
2024-11-14,삼성중공업,14,6,4,24,0.6999999650000017,0.29999998500000075
2024-11-14,세진중공업,0,2,0,2,0.0,0.99999950000025
2024-11-14,한국카본,1,5,0,6,0.16666663888889352,0.8333331944444675
2024-11-14,한화엔진,6,5,3,14,0.5454544958677732,0.4545454132231443
2024-11-14,한화오션,61,29,14,104,0.6777777702469137,0.32222221864197537
2024-11-15,HD한국조선해양,13,4,1,18,0.7647058373702448,0.23529410380622917
2024-11-15,HD현대마린솔루션,4,1,0,5,0.799999840000032,0.199999960000008
2024-11-15,HD현대마린엔진,0,1,0,1,0.0,0.9999990000010001
2024-11-15,HD현대미포,4,0,0,4,0.9999997500000625,0.0
2024-11-15,HD현대중공업,52,7,7,66,0.8813559172651539,0.11864406578569381
2024-11-15,삼성중공업,10,2,5,17,0.8333332638888947,0.16666665277777895
2024-11-15,세진중공업,0,0,3,3,0.0,0.0
2024-11-15,한국카본,2,0,0,2,0.99999950000025,0.0
2024-11-15,한화엔진,4,3,1,8,0.57142848979593,0.4285713673469475
2024-11-15,한화오션,75,12,8,95,0.8620689556084028,0.13793103289734446
2024-11-16,HD한국조선해양,4,1,0,5,0.799999840000032,0.199999960000008
2024-11-16,HD현대마린엔진,1,0,0,1,0.9999990000010001,0.0
2024-11-16,HD현대미포,1,1,0,2,0.499999750000125,0.499999750000125
2024-11-16,HD현대중공업,8,1,1,10,0.8888887901234679,0.11111109876543349
2024-11-16,STX엔진,1,0,1,2,0.9999990000010001,0.0
2024-11-16,삼성중공업,2,2,1,5,0.49999987500003124,0.49999987500003124
2024-11-16,한국카본,0,1,0,1,0.0,0.9999990000010001
2024-11-16,한화엔진,3,1,0,4,0.7499998125000469,0.24999993750001562
2024-11-16,한화오션,7,6,1,14,0.5384614970414233,0.4615384260355057
2024-11-17,HD한국조선해양,2,2,1,5,0.49999987500003124,0.49999987500003124
2024-11-17,HD현대마린솔루션,1,0,0,1,0.9999990000010001,0.0
2024-11-17,HD현대미포,2,1,0,3,0.6666664444445185,0.33333322222225925
2024-11-17,HD현대중공업,23,2,4,29,0.9199999632000014,0.07999999680000013
2024-11-17,STX엔진,1,0,0,1,0.9999990000010001,0.0
2024-11-17,삼성중공업,3,2,5,10,0.599999880000024,0.399999920000016
2024-11-17,한국카본,1,0,0,1,0.9999990000010001,0.0
2024-11-17,한화엔진,1,0,2,3,0.9999990000010001,0.0
2024-11-17,한화오션,15,5,4,24,0.7499999625000018,0.2499999875000006
2024-11-18,HD한국조선해양,55,8,2,65,0.8730158591584785,0.12698412496850595
2024-11-18,HD현대마린솔루션,3,2,1,6,0.599999880000024,0.399999920000016
2024-11-18,HD현대미포,4,3,2,9,0.57142848979593,0.4285713673469475
2024-11-18,HD현대중공업,107,36,5,148,0.7482517430192186,0.25174824998777445
2024-11-18,삼성중공업,13,10,1,24,0.5652173667296797,0.4347825897920613
2024-11-18,세진중공업,1,0,0,1,0.9999990000010001,0.0
2024-11-18,한화엔진,6,2,0,8,0.7499999062500118,0.24999996875000394
2024-11-18,한화오션,38,18,6,62,0.6785714164540819,0.32142856568877565
2024-11-19,HD한국조선해양,20,9,2,31,0.689655148632581,0.3103448168846615
2024-11-19,HD현대마린솔루션,7,3,0,10,0.699999930000007,0.299999970000003
2024-11-19,HD현대마린엔진,2,2,0,4,0.49999987500003124,0.49999987500003124
2024-11-19,HD현대미포,9,6,0,15,0.5999999600000027,0.39999997333333515
2024-11-19,HD현대중공업,30,17,3,50,0.6382978587596201,0.3617021199637847
2024-11-19,STX엔진,1,1,0,2,0.499999750000125,0.499999750000125
2024-11-19,삼성중공업,19,14,3,36,0.5757575583103771,0.42424241138659363
2024-11-19,세진중공업,0,0,1,1,0.0,0.0
2024-11-19,한국카본,2,1,1,4,0.6666664444445185,0.33333322222225925
2024-11-19,한화엔진,7,4,1,12,0.636363578512402,0.3636363305785154
2024-11-19,한화오션,41,16,11,68,0.7192982329947679,0.28070174946137283
2024-11-20,HD한국조선해양,23,7,4,34,0.7666666411111119,0.2333333255555558
2024-11-20,HD현대마린솔루션,5,2,2,9,0.7142856122449125,0.285714244897965
2024-11-20,HD현대마린엔진,1,4,1,6,0.199999960000008,0.799999840000032
2024-11-20,HD현대미포,7,6,0,13,0.5384614970414233,0.4615384260355057
2024-11-20,HD현대중공업,39,14,4,57,0.7358490427198294,0.26415093841224646
2024-11-20,STX엔진,2,1,0,3,0.6666664444445185,0.33333322222225925
2024-11-20,삼성중공업,38,7,4,49,0.8444444256790128,0.1555555520987655
2024-11-20,세진중공업,0,4,1,5,0.0,0.9999997500000625
2024-11-20,한국카본,0,1,0,1,0.0,0.9999990000010001
2024-11-20,한화엔진,8,7,0,15,0.5333332977777802,0.46666663555555765
2024-11-20,한화오션,81,16,10,107,0.8350515377829738,0.16494845190774793
2024-11-21,HD한국조선해양,14,2,4,20,0.8749999453125034,0.12499999218750048
2024-11-21,HD현대마린솔루션,3,1,3,7,0.7499998125000469,0.24999993750001562
2024-11-21,HD현대마린엔진,0,1,1,2,0.0,0.9999990000010001
2024-11-21,HD현대미포,7,2,1,10,0.7777776913580343,0.22222219753086697
2024-11-21,HD현대중공업,49,9,14,72,0.8448275716409039,0.15517241111771707
2024-11-21,삼성중공업,19,3,1,23,0.863636324380167,0.13636363016528952
2024-11-21,한국카본,0,1,0,1,0.0,0.9999990000010001
2024-11-21,한화엔진,12,1,5,18,0.9230768520710114,0.07692307100591762
2024-11-21,한화오션,41,5,11,57,0.8913043284499059,0.10869564981096413
2024-11-22,HD한국조선해양,17,3,3,23,0.8499999575000021,0.14999999250000037
2024-11-22,HD현대마린솔루션,3,1,0,4,0.7499998125000469,0.24999993750001562
2024-11-22,HD현대마린엔진,10,1,0,11,0.9090908264462886,0.09090908264462885
2024-11-22,HD현대미포,8,3,0,11,0.7272726611570308,0.2727272479338866
2024-11-22,HD현대중공업,117,21,7,145,0.8478260808128545,0.15217391194076876
2024-11-22,STX엔진,10,1,0,11,0.9090908264462886,0.09090908264462885
2024-11-22,삼성중공업,14,2,1,17,0.8749999453125034,0.12499999218750048
2024-11-22,세진중공업,0,2,1,3,0.0,0.99999950000025
2024-11-22,한국카본,3,2,0,5,0.599999880000024,0.399999920000016
2024-11-22,한화엔진,12,2,2,16,0.8571427959183717,0.14285713265306196
2024-11-22,한화오션,93,25,10,128,0.7881355865412238,0.21186440498419995
2024-11-23,HD한국조선해양,8,2,0,10,0.7999999200000081,0.19999998000000202
2024-11-23,HD현대미포,2,1,0,3,0.6666664444445185,0.33333322222225925
2024-11-23,HD현대중공업,11,2,3,16,0.8461537810650938,0.15384614201183525
2024-11-23,STX엔진,1,0,0,1,0.9999990000010001,0.0
2024-11-23,삼성중공업,3,0,1,4,0.9999996666667778,0.0
2024-11-23,한화엔진,3,0,0,3,0.9999996666667778,0.0
2024-11-23,한화오션,12,1,3,16,0.9230768520710114,0.07692307100591762
2024-11-24,HD한국조선해양,1,2,0,3,0.33333322222225925,0.6666664444445185
2024-11-24,HD현대마린엔진,3,1,0,4,0.7499998125000469,0.24999993750001562
2024-11-24,HD현대미포,5,0,0,5,0.99999980000004,0.0
2024-11-24,HD현대중공업,9,4,1,14,0.6923076390532585,0.3076922840236705
2024-11-24,STX엔진,3,1,0,4,0.7499998125000469,0.24999993750001562
2024-11-24,삼성중공업,5,2,0,7,0.7142856122449125,0.285714244897965
2024-11-24,한화엔진,1,2,2,5,0.33333322222225925,0.6666664444445185
2024-11-24,한화오션,13,4,2,19,0.7647058373702448,0.23529410380622917
2024-11-25,HD한국조선해양,62,11,4,77,0.8493150568586979,0.1506849294426722
2024-11-25,HD현대마린솔루션,19,1,1,21,0.9499999525000024,0.04999999750000012
2024-11-25,HD현대마린엔진,18,2,0,20,0.8999999550000022,0.09999999500000024
2024-11-25,HD현대미포,31,6,3,40,0.8378378151935726,0.16216215777940116
2024-11-25,HD현대중공업,145,18,8,171,0.8895705466897512,0.11042944717527947
2024-11-25,STX엔진,2,1,0,3,0.6666664444445185,0.33333322222225925
2024-11-25,삼성중공업,28,10,4,42,0.7368420858725767,0.26315788781163457
2024-11-25,세진중공업,0,2,0,2,0.0,0.99999950000025
2024-11-25,한국카본,1,1,0,2,0.499999750000125,0.499999750000125
2024-11-25,한화엔진,9,5,1,15,0.6428570969387788,0.3571428316326549
2024-11-25,한화오션,67,13,7,87,0.8374999895312502,0.16249999796875003
2024-11-26,HD한국조선해양,13,13,5,31,0.49999998076923147,0.49999998076923147
2024-11-26,HD현대마린솔루션,7,1,1,9,0.8749998906250137,0.12499998437500197
2024-11-26,HD현대마린엔진,8,1,0,9,0.8888887901234679,0.11111109876543349
2024-11-26,HD현대미포,6,6,3,15,0.4999999583333368,0.4999999583333368
2024-11-26,HD현대중공업,24,17,13,54,0.585365839381321,0.4146341362284357
2024-11-26,STX엔진,1,0,0,1,0.9999990000010001,0.0
2024-11-26,삼성중공업,22,10,6,38,0.6874999785156257,0.3124999902343753
2024-11-26,한국카본,1,0,0,1,0.9999990000010001,0.0
2024-11-26,한화엔진,14,5,1,20,0.7368420664819965,0.26315788088642733
2024-11-26,한화오션,27,17,14,58,0.613636349690083,0.38636362758264486
2024-11-27,HD한국조선해양,25,4,3,32,0.8620689357907263,0.13793102972651622
2024-11-27,HD현대마린솔루션,7,0,3,10,0.9999998571428775,0.0
2024-11-27,HD현대마린엔진,3,0,0,3,0.9999996666667778,0.0
2024-11-27,HD현대미포,11,5,5,21,0.6874999570312527,0.3124999804687512
2024-11-27,HD현대중공업,132,13,16,161,0.9103448213079668,0.08965517179548158
2024-11-27,STX엔진,6,1,0,7,0.857142734693895,0.1428571224489825
2024-11-27,삼성중공업,17,9,3,29,0.6538461286982258,0.3461538328402372
2024-11-27,한국카본,1,0,0,1,0.9999990000010001,0.0
2024-11-27,한화엔진,13,1,0,14,0.9285713622449028,0.07142856632653098
2024-11-27,한화오션,36,9,5,50,0.7999999822222227,0.19999999555555567
2024-11-28,HD한국조선해양,17,1,7,25,0.9444443919753115,0.055555552469135974
2024-11-28,HD현대마린솔루션,5,1,1,7,0.8333331944444675,0.16666663888889352
2024-11-28,HD현대마린엔진,0,1,0,1,0.0,0.9999990000010001
2024-11-28,HD현대미포,5,4,1,10,0.5555554938271674,0.44444439506173394
2024-11-28,HD현대중공업,35,9,11,55,0.7954545273760335,0.20454544989669432
2024-11-28,STX엔진,2,1,0,3,0.6666664444445185,0.33333322222225925
2024-11-28,삼성중공업,12,8,4,24,0.5999999700000015,0.399999980000001
2024-11-28,세진중공업,1,0,0,1,0.9999990000010001,0.0
2024-11-28,한국카본,1,0,0,1,0.9999990000010001,0.0
2024-11-28,한화엔진,3,2,0,5,0.599999880000024,0.399999920000016
2024-11-28,한화오션,22,11,8,41,0.6666666464646471,0.33333332323232356
2024-11-29,HD한국조선해양,17,5,3,25,0.7727272376033073,0.2272727169421492
2024-11-29,HD현대마린솔루션,6,1,0,7,0.857142734693895,0.1428571224489825
2024-11-29,HD현대마린엔진,5,5,0,10,0.499999950000005,0.499999950000005
2024-11-29,HD현대미포,6,4,1,11,0.599999940000006,0.39999996000000404
2024-11-29,HD현대중공업,29,7,5,41,0.8055555331790131,0.19444443904321004
2024-11-29,STX엔진,0,2,0,2,0.0,0.99999950000025
2024-11-29,삼성중공업,13,7,4,24,0.6499999675000016,0.34999998250000086
2024-11-29,한국카본,1,0,0,1,0.9999990000010001,0.0
2024-11-29,한화엔진,8,3,0,11,0.7272726611570308,0.2727272479338866
2024-11-29,한화오션,33,11,10,54,0.7499999829545458,0.24999999431818196
2024-11-30,HD한국조선해양,7,0,2,9,0.9999998571428775,0.0
2024-11-30,HD현대마린솔루션,1,0,0,1,0.9999990000010001,0.0
2024-11-30,HD현대마린엔진,1,0,0,1,0.9999990000010001,0.0
2024-11-30,HD현대미포,1,0,0,1,0.9999990000010001,0.0
2024-11-30,HD현대중공업,9,0,1,10,0.9999998888889013,0.0
2024-11-30,삼성중공업,0,1,1,2,0.0,0.9999990000010001
2024-11-30,한화엔진,3,1,1,5,0.7499998125000469,0.24999993750001562
2024-11-30,한화오션,6,1,1,8,0.857142734693895,0.1428571224489825
2024-12-01,HD한국조선해양,10,2,2,14,0.8333332638888947,0.16666665277777895
2024-12-01,HD현대마린솔루션,2,0,0,2,0.99999950000025,0.0
2024-12-01,HD현대마린엔진,2,0,0,2,0.99999950000025,0.0
2024-12-01,HD현대미포,1,0,1,2,0.9999990000010001,0.0
2024-12-01,HD현대중공업,10,1,0,11,0.9090908264462886,0.09090908264462885
2024-12-01,STX엔진,0,0,1,1,0.0,0.0
2024-12-01,삼성중공업,6,2,0,8,0.7499999062500118,0.24999996875000394
2024-12-01,세진중공업,2,0,0,2,0.99999950000025,0.0
2024-12-01,한화엔진,6,0,1,7,0.9999998333333611,0.0
2024-12-01,한화오션,12,2,4,18,0.8571427959183717,0.14285713265306196
2024-12-02,HD한국조선해양,11,3,6,20,0.7857142295918408,0.21428569897959293
2024-12-02,HD현대마린솔루션,1,0,2,3,0.9999990000010001,0.0
2024-12-02,HD현대미포,10,3,1,14,0.7692307100591762,0.23076921301775286
2024-12-02,HD현대중공업,20,5,8,33,0.7999999680000013,0.19999999200000032
2024-12-02,STX엔진,1,0,0,1,0.9999990000010001,0.0
2024-12-02,삼성중공업,9,6,8,23,0.5999999600000027,0.39999997333333515
2024-12-02,세진중공업,1,2,0,3,0.33333322222225925,0.6666664444445185
2024-12-02,한국카본,1,0,0,1,0.9999990000010001,0.0
2024-12-02,한화엔진,11,3,0,14,0.7857142295918408,0.21428569897959293
2024-12-02,한화오션,24,10,8,42,0.7058823321799315,0.2941176384083048
2024-12-03,HD한국조선해양,11,6,1,18,0.6470587854671302,0.35294115570934376
2024-12-03,HD현대마린솔루션,4,1,0,5,0.799999840000032,0.199999960000008
2024-12-03,HD현대마린엔진,4,4,0,8,0.4999999375000079,0.4999999375000079
2024-12-03,HD현대미포,9,4,1,14,0.6923076390532585,0.3076922840236705
2024-12-03,HD현대중공업,22,12,1,35,0.6470588044982705,0.35294116608996573
2024-12-03,STX엔진,6,4,0,10,0.599999940000006,0.39999996000000404
2024-12-03,삼성중공업,8,6,1,15,0.5714285306122479,0.42857139795918586
2024-12-03,세진중공업,4,4,0,8,0.4999999375000079,0.4999999375000079
2024-12-03,한국카본,5,4,0,9,0.5555554938271674,0.44444439506173394
2024-12-03,한화엔진,12,5,0,17,0.7058823114186875,0.2941176297577865
2024-12-03,한화오션,22,17,4,43,0.5641025496383962,0.4358974247205789
2024-12-04,HD한국조선해양,10,3,4,17,0.7692307100591762,0.23076921301775286
2024-12-04,HD현대마린솔루션,4,0,0,4,0.9999997500000625,0.0
2024-12-04,HD현대마린엔진,1,0,0,1,0.9999990000010001,0.0
2024-12-04,HD현대미포,15,5,0,20,0.7499999625000018,0.2499999875000006
2024-12-04,HD현대중공업,17,10,16,43,0.6296296063100145,0.37037035665294976
2024-12-04,STX엔진,3,0,0,3,0.9999996666667778,0.0
2024-12-04,삼성중공업,26,3,4,33,0.8965516932223554,0.10344827229488716
2024-12-04,세진중공업,0,2,0,2,0.0,0.99999950000025
2024-12-04,한국카본,1,0,0,1,0.9999990000010001,0.0
2024-12-04,한화엔진,7,1,0,8,0.8749998906250137,0.12499998437500197
2024-12-04,한화오션,22,6,9,37,0.7857142576530622,0.21428570663265334
2024-12-05,HD한국조선해양,10,2,4,16,0.8333332638888947,0.16666665277777895
2024-12-05,HD현대마린솔루션,0,0,1,1,0.0,0.0
2024-12-05,HD현대마린엔진,2,0,0,2,0.99999950000025,0.0
2024-12-05,HD현대미포,3,3,0,6,0.49999991666668053,0.49999991666668053
2024-12-05,HD현대중공업,16,3,6,25,0.8421052188365674,0.15789472853185638
2024-12-05,STX엔진,4,0,0,4,0.9999997500000625,0.0
2024-12-05,삼성중공업,17,4,1,22,0.8095237709750585,0.19047618140589612
2024-12-05,세진중공업,0,1,0,1,0.0,0.9999990000010001
2024-12-05,한국카본,1,0,0,1,0.9999990000010001,0.0
2024-12-05,한화엔진,9,1,0,10,0.8999999100000091,0.09999999000000101
2024-12-05,한화오션,22,5,7,34,0.8148147846364894,0.18518517832647488
2024-12-06,HD한국조선해양,9,5,4,18,0.6428570969387788,0.3571428316326549
2024-12-06,HD현대마린솔루션,3,6,1,10,0.33333329629630043,0.6666665925926009
2024-12-06,HD현대마린엔진,1,0,0,1,0.9999990000010001,0.0
2024-12-06,HD현대미포,2,0,2,4,0.99999950000025,0.0
2024-12-06,HD현대중공업,11,3,5,19,0.7857142295918408,0.21428569897959293
2024-12-06,STX엔진,0,0,1,1,0.0,0.0
2024-12-06,삼성중공업,11,4,2,17,0.7333332844444478,0.2666666488888901
2024-12-06,한국카본,2,0,0,2,0.99999950000025,0.0
2024-12-06,한화엔진,4,0,2,6,0.9999997500000625,0.0
2024-12-06,한화오션,13,6,8,27,0.684210490304711,0.31578945706371275
2024-12-07,HD한국조선해양,2,0,0,2,0.99999950000025,0.0
2024-12-07,HD현대마린솔루션,1,0,1,2,0.9999990000010001,0.0
2024-12-07,HD현대중공업,2,1,1,4,0.6666664444445185,0.33333322222225925
2024-12-07,삼성중공업,1,1,0,2,0.499999750000125,0.499999750000125
2024-12-07,한화엔진,1,0,0,1,0.9999990000010001,0.0
2024-12-07,한화오션,14,0,2,16,0.9999999285714337,0.0
2024-12-08,HD한국조선해양,4,3,2,9,0.57142848979593,0.4285713673469475
2024-12-08,HD현대미포,2,0,0,2,0.99999950000025,0.0
2024-12-08,HD현대중공업,8,2,5,15,0.7999999200000081,0.19999998000000202
2024-12-08,삼성중공업,1,2,1,4,0.33333322222225925,0.6666664444445185
2024-12-08,한화엔진,4,1,0,5,0.799999840000032,0.199999960000008
2024-12-08,한화오션,16,5,4,25,0.7619047256235845,0.23809522675737013
2024-12-09,HD한국조선해양,6,5,1,12,0.5454544958677732,0.4545454132231443
2024-12-09,HD현대마린솔루션,2,0,2,4,0.99999950000025,0.0
2024-12-09,HD현대미포,1,1,1,3,0.499999750000125,0.499999750000125
2024-12-09,HD현대중공업,13,5,9,27,0.7222221820987677,0.27777776234567986
2024-12-09,삼성중공업,16,4,9,29,0.799999960000002,0.1999999900000005
2024-12-09,한국카본,2,1,0,3,0.6666664444445185,0.33333322222225925
2024-12-09,한화엔진,3,2,0,5,0.599999880000024,0.399999920000016
2024-12-09,한화오션,22,6,18,46,0.7857142576530622,0.21428570663265334
2024-12-10,HD한국조선해양,16,3,3,22,0.8421052188365674,0.15789472853185638
2024-12-10,HD현대마린솔루션,3,2,3,8,0.599999880000024,0.399999920000016
2024-12-10,HD현대마린엔진,1,1,0,2,0.499999750000125,0.499999750000125
2024-12-10,HD현대미포,10,2,0,12,0.8333332638888947,0.16666665277777895
2024-12-10,HD현대중공업,25,9,8,42,0.7352940960207619,0.2647058745674743
2024-12-10,STX엔진,3,0,0,3,0.9999996666667778,0.0
2024-12-10,삼성중공업,23,8,4,35,0.7419354599375658,0.2580645078043707
2024-12-10,세진중공업,1,1,0,2,0.499999750000125,0.499999750000125
2024-12-10,한국카본,7,1,0,8,0.8749998906250137,0.12499998437500197
2024-12-10,한화엔진,3,2,1,6,0.599999880000024,0.399999920000016
2024-12-10,한화오션,29,17,7,53,0.6304347689035921,0.3695652093572781
2024-12-11,HD한국조선해양,12,28,3,43,0.2999999925000002,0.6999999825000005
2024-12-11,HD현대마린솔루션,4,9,0,13,0.3076922840236705,0.6923076390532585
2024-12-11,HD현대마린엔진,5,5,0,10,0.499999950000005,0.499999950000005
2024-12-11,HD현대미포,6,25,2,33,0.19354838085327802,0.8064515868886585
2024-12-11,HD현대중공업,12,25,7,44,0.3243243155588023,0.6756756574141715
2024-12-11,STX엔진,1,4,0,5,0.199999960000008,0.799999840000032
2024-12-11,삼성중공업,11,25,2,38,0.3055555470679015,0.6944444251543216
2024-12-11,세진중공업,0,3,0,3,0.0,0.9999996666667778
2024-12-11,한국카본,2,3,0,5,0.399999920000016,0.599999880000024
2024-12-11,한화엔진,3,9,1,13,0.2499999791666684,0.7499999375000053
2024-12-11,한화오션,94,27,13,134,0.776859497711905,0.22314049402363229
2024-12-12,HD한국조선해양,18,5,3,26,0.7826086616257103,0.21739129489603065
2024-12-12,HD현대마린솔루션,4,5,1,10,0.44444439506173394,0.5555554938271674
2024-12-12,HD현대마린엔진,4,3,0,7,0.57142848979593,0.4285713673469475
2024-12-12,HD현대미포,5,4,1,10,0.5555554938271674,0.44444439506173394
2024-12-12,HD현대중공업,19,4,5,28,0.8260869206049165,0.17391303591682453
2024-12-12,STX엔진,0,1,0,1,0.0,0.9999990000010001
2024-12-12,삼성중공업,8,4,0,12,0.6666666111111158,0.3333333055555579
2024-12-12,세진중공업,3,1,1,5,0.7499998125000469,0.24999993750001562
2024-12-12,한국카본,0,1,1,2,0.0,0.9999990000010001
2024-12-12,한화엔진,9,1,0,10,0.8999999100000091,0.09999999000000101
2024-12-12,한화오션,48,13,8,69,0.7868852330018815,0.21311475060467622
2024-12-13,HD한국조선해양,12,8,3,23,0.5999999700000015,0.399999980000001
2024-12-13,HD현대마린솔루션,12,6,0,18,0.6666666296296316,0.3333333148148158
2024-12-13,HD현대마린엔진,12,5,1,18,0.7058823114186875,0.2941176297577865
2024-12-13,HD현대미포,9,5,0,14,0.6428570969387788,0.3571428316326549
2024-12-13,HD현대중공업,16,16,8,40,0.49999998437500054,0.49999998437500054
2024-12-13,삼성중공업,10,7,2,19,0.588235259515573,0.4117646816609011
2024-12-13,세진중공업,9,4,0,13,0.6923076390532585,0.3076922840236705
2024-12-13,한국카본,11,5,0,16,0.6874999570312527,0.3124999804687512
2024-12-13,한화엔진,10,4,1,15,0.7142856632653098,0.2857142653061239
2024-12-13,한화오션,17,16,8,41,0.5151514995408637,0.484848470156107
2024-12-14,HD한국조선해양,3,1,1,5,0.7499998125000469,0.24999993750001562
2024-12-14,HD현대마린솔루션,3,1,0,4,0.7499998125000469,0.24999993750001562
2024-12-14,HD현대마린엔진,2,1,0,3,0.6666664444445185,0.33333322222225925
2024-12-14,HD현대미포,2,1,1,4,0.6666664444445185,0.33333322222225925
2024-12-14,HD현대중공업,8,2,0,10,0.7999999200000081,0.19999998000000202
2024-12-14,STX엔진,1,0,0,1,0.9999990000010001,0.0
2024-12-14,삼성중공업,2,1,1,4,0.6666664444445185,0.33333322222225925
2024-12-14,세진중공업,2,1,0,3,0.6666664444445185,0.33333322222225925
2024-12-14,한국카본,2,1,0,3,0.6666664444445185,0.33333322222225925
2024-12-14,한화엔진,3,2,0,5,0.599999880000024,0.399999920000016
2024-12-14,한화오션,7,2,1,10,0.7777776913580343,0.22222219753086697
2024-12-15,HD한국조선해양,3,4,8,15,0.4285713673469475,0.57142848979593
2024-12-15,HD현대마린솔루션,2,0,0,2,0.99999950000025,0.0
2024-12-15,HD현대마린엔진,2,0,0,2,0.99999950000025,0.0
2024-12-15,HD현대미포,5,3,7,15,0.6249999218750099,0.3749999531250059
2024-12-15,HD현대중공업,9,2,9,20,0.8181817438016598,0.1818181652892577
2024-12-15,삼성중공업,3,2,9,14,0.599999880000024,0.399999920000016
2024-12-15,세진중공업,1,0,0,1,0.9999990000010001,0.0
2024-12-15,한국카본,1,0,0,1,0.9999990000010001,0.0
2024-12-15,한화엔진,8,0,0,8,0.9999998750000157,0.0
2024-12-15,한화오션,6,8,7,21,0.42857139795918586,0.5714285306122479
2024-12-16,HD한국조선해양,21,6,5,32,0.7777777489711944,0.22222221399176983
2024-12-16,HD현대마린솔루션,1,1,0,2,0.499999750000125,0.499999750000125
2024-12-16,HD현대마린엔진,1,2,1,4,0.33333322222225925,0.6666664444445185
2024-12-16,HD현대미포,3,7,4,14,0.299999970000003,0.699999930000007
2024-12-16,HD현대중공업,20,9,9,38,0.689655148632581,0.3103448168846615
2024-12-16,STX엔진,1,0,0,1,0.9999990000010001,0.0
2024-12-16,삼성중공업,16,7,8,31,0.6956521436672981,0.3043478128544429
2024-12-16,세진중공업,1,0,0,1,0.9999990000010001,0.0
2024-12-16,한국카본,1,0,0,1,0.9999990000010001,0.0
2024-12-16,한화엔진,7,4,2,13,0.636363578512402,0.3636363305785154
2024-12-16,한화오션,50,14,12,76,0.781249987792969,0.21874999658203131
2024-12-17,HD한국조선해양,14,6,4,24,0.6999999650000017,0.29999998500000075
2024-12-17,HD현대마린솔루션,4,6,0,10,0.39999996000000404,0.599999940000006
2024-12-17,HD현대마린엔진,0,3,0,3,0.0,0.9999996666667778
2024-12-17,HD현대미포,7,5,1,13,0.5833332847222263,0.41666663194444736
2024-12-17,HD현대중공업,23,9,17,49,0.7187499775390632,0.2812499912109378
2024-12-17,STX엔진,2,0,0,2,0.99999950000025,0.0
2024-12-17,삼성중공업,16,3,4,23,0.8421052188365674,0.15789472853185638
2024-12-17,세진중공업,0,1,0,1,0.0,0.9999990000010001
2024-12-17,한국카본,1,0,0,1,0.9999990000010001,0.0
2024-12-17,한화엔진,10,4,1,15,0.7142856632653098,0.2857142653061239
2024-12-17,한화오션,30,5,9,44,0.857142832653062,0.14285713877551032
2024-12-18,HD한국조선해양,31,9,3,43,0.7749999806250005,0.22499999437500015
2024-12-18,HD현대마린솔루션,6,3,0,9,0.6666665925926009,0.33333329629630043
2024-12-18,HD현대마린엔진,1,3,1,5,0.24999993750001562,0.7499998125000469
2024-12-18,HD현대미포,8,9,3,20,0.47058820761245834,0.5294117335640156
2024-12-18,HD현대중공업,61,18,8,87,0.7721518889601027,0.22784809838166964
2024-12-18,STX엔진,1,0,0,1,0.9999990000010001,0.0
2024-12-18,삼성중공업,14,8,2,24,0.6363636074380178,0.36363634710743875
2024-12-18,세진중공업,1,2,0,3,0.33333322222225925,0.6666664444445185
2024-12-18,한국카본,0,1,0,1,0.0,0.9999990000010001
2024-12-18,한화엔진,7,5,0,12,0.5833332847222263,0.41666663194444736
2024-12-18,한화오션,58,13,10,81,0.8169013969450508,0.18309858897044243
2024-12-19,HD한국조선해양,9,7,11,27,0.5624999648437522,0.4374999726562517
2024-12-19,HD현대마린솔루션,4,1,5,10,0.799999840000032,0.199999960000008
2024-12-19,HD현대마린엔진,1,1,3,5,0.499999750000125,0.499999750000125
2024-12-19,HD현대미포,5,2,14,21,0.7142856122449125,0.285714244897965
2024-12-19,HD현대중공업,19,11,37,67,0.6333333122222229,0.36666665444444485
2024-12-19,STX엔진,1,2,1,4,0.33333322222225925,0.6666664444445185
2024-12-19,삼성중공업,8,8,6,22,0.4999999687500019,0.4999999687500019
2024-12-19,세진중공업,0,3,0,3,0.0,0.9999996666667778
2024-12-19,한국카본,0,3,0,3,0.0,0.9999996666667778
2024-12-19,한화엔진,8,3,5,16,0.7272726611570308,0.2727272479338866
2024-12-19,한화오션,36,12,7,55,0.7499999843750004,0.2499999947916668
2024-12-20,HD한국조선해양,14,8,2,24,0.6363636074380178,0.36363634710743875
2024-12-20,HD현대마린솔루션,7,3,5,15,0.699999930000007,0.299999970000003
2024-12-20,HD현대마린엔진,1,0,0,1,0.9999990000010001,0.0
2024-12-20,HD현대미포,6,2,4,12,0.7499999062500118,0.24999996875000394
2024-12-20,HD현대중공업,33,12,43,88,0.7333333170370374,0.2666666607407409
2024-12-20,삼성중공업,6,7,1,14,0.4615384260355057,0.5384614970414233
2024-12-20,세진중공업,1,1,0,2,0.499999750000125,0.499999750000125
2024-12-20,한화엔진,11,3,0,14,0.7857142295918408,0.21428569897959293
2024-12-20,한화오션,111,15,18,144,0.8809523739606955,0.11904761810279668
2024-12-21,HD한국조선해양,7,3,0,10,0.699999930000007,0.299999970000003
2024-12-21,HD현대마린솔루션,2,0,2,4,0.99999950000025,0.0
2024-12-21,HD현대미포,4,0,0,4,0.9999997500000625,0.0
2024-12-21,HD현대중공업,7,3,0,10,0.699999930000007,0.299999970000003
2024-12-21,STX엔진,0,1,0,1,0.0,0.9999990000010001
2024-12-21,삼성중공업,3,3,0,6,0.49999991666668053,0.49999991666668053
2024-12-21,세진중공업,0,1,0,1,0.0,0.9999990000010001
2024-12-21,한국카본,1,1,0,2,0.499999750000125,0.499999750000125
2024-12-21,한화엔진,6,0,1,7,0.9999998333333611,0.0
2024-12-21,한화오션,14,5,0,19,0.7368420664819965,0.26315788088642733
2024-12-22,HD한국조선해양,5,1,2,8,0.8333331944444675,0.16666663888889352
2024-12-22,HD현대마린솔루션,0,0,2,2,0.0,0.0
2024-12-22,HD현대미포,4,2,0,6,0.6666665555555741,0.33333327777778704
2024-12-22,HD현대중공업,10,2,1,13,0.8333332638888947,0.16666665277777895
2024-12-22,삼성중공업,6,2,2,10,0.7499999062500118,0.24999996875000394
2024-12-22,한화엔진,2,0,0,2,0.99999950000025,0.0
2024-12-22,한화오션,12,1,3,16,0.9230768520710114,0.07692307100591762
2024-12-23,HD한국조선해양,14,28,4,46,0.3333333253968256,0.6666666507936512
2024-12-23,HD현대마린솔루션,5,3,2,10,0.6249999218750099,0.3749999531250059
2024-12-23,HD현대마린엔진,3,2,0,5,0.599999880000024,0.399999920000016
2024-12-23,HD현대미포,11,7,1,19,0.6111110771604957,0.3888888672839518
2024-12-23,HD현대중공업,30,26,5,61,0.5357142761479594,0.4642857059948981
2024-12-23,STX엔진,2,4,0,6,0.33333327777778704,0.6666665555555741
2024-12-23,삼성중공업,11,10,1,22,0.5238094988662143,0.47619045351474026
2024-12-23,세진중공업,0,3,0,3,0.0,0.9999996666667778
2024-12-23,한국카본,5,5,0,10,0.499999950000005,0.499999950000005
2024-12-23,한화엔진,9,10,1,20,0.47368418559556913,0.5263157617728547
2024-12-23,한화오션,36,34,4,74,0.5142857069387756,0.4857142787755103
2024-12-24,HD한국조선해양,20,16,3,39,0.5555555401234572,0.44444443209876583
2024-12-24,HD현대마린솔루션,10,6,1,17,0.6249999609375024,0.37499997656250145
2024-12-24,HD현대마린엔진,9,4,0,13,0.6923076390532585,0.3076922840236705
2024-12-24,HD현대미포,10,5,3,18,0.6666666222222252,0.3333333111111126
2024-12-24,HD현대중공업,25,14,17,56,0.6410256245890866,0.3589743497698885
2024-12-24,삼성중공업,14,6,9,29,0.6999999650000017,0.29999998500000075
2024-12-24,세진중공업,8,2,0,10,0.7999999200000081,0.19999998000000202
2024-12-24,한국카본,8,3,0,11,0.7272726611570308,0.2727272479338866
2024-12-24,한화엔진,17,5,0,22,0.7727272376033073,0.2272727169421492
2024-12-24,한화오션,34,13,3,50,0.7234042399275694,0.2765957387958354
2024-12-25,HD한국조선해양,7,9,0,16,0.4374999726562517,0.5624999648437522
2024-12-25,HD현대마린솔루션,2,5,0,7,0.285714244897965,0.7142856122449125
2024-12-25,HD현대마린엔진,1,4,0,5,0.199999960000008,0.799999840000032
2024-12-25,HD현대미포,1,6,0,7,0.1428571224489825,0.857142734693895
2024-12-25,HD현대중공업,8,9,2,19,0.47058820761245834,0.5294117335640156
2024-12-25,삼성중공업,6,2,2,10,0.7499999062500118,0.24999996875000394
2024-12-25,세진중공업,1,4,0,5,0.199999960000008,0.799999840000032
2024-12-25,한국카본,0,4,0,4,0.0,0.9999997500000625
2024-12-25,한화엔진,2,7,0,9,0.22222219753086697,0.7777776913580343
2024-12-25,한화오션,9,8,1,18,0.5294117335640156,0.47058820761245834
2024-12-26,HD한국조선해양,25,26,16,67,0.49019606881968497,0.5098039115724724
2024-12-26,HD현대마린솔루션,6,1,8,15,0.857142734693895,0.1428571224489825
2024-12-26,HD현대마린엔진,6,8,5,19,0.42857139795918586,0.5714285306122479
2024-12-26,HD현대미포,3,14,2,19,0.17647057785467188,0.8235293633218022
2024-12-26,HD현대중공업,30,39,43,112,0.43478260239445504,0.5652173831127916
2024-12-26,STX엔진,4,6,0,10,0.39999996000000404,0.599999940000006
2024-12-26,삼성중공업,25,30,20,75,0.4545454462809919,0.5454545355371903
2024-12-26,세진중공업,0,2,0,2,0.0,0.99999950000025
2024-12-26,한국카본,0,1,0,1,0.0,0.9999990000010001
2024-12-26,한화엔진,15,19,5,39,0.44117645761245716,0.558823512975779
2024-12-26,한화오션,46,39,26,111,0.5411764642214534,0.4588235240138409
2024-12-27,HD한국조선해양,10,10,7,27,0.4999999750000012,0.4999999750000012
2024-12-27,HD현대마린솔루션,6,5,2,13,0.5454544958677732,0.4545454132231443
2024-12-27,HD현대마린엔진,4,6,0,10,0.39999996000000404,0.599999940000006
2024-12-27,HD현대미포,4,4,4,12,0.4999999375000079,0.4999999375000079
2024-12-27,HD현대중공업,9,20,33,62,0.3103448168846615,0.689655148632581
2024-12-27,STX엔진,0,1,0,1,0.0,0.9999990000010001
2024-12-27,삼성중공업,14,13,15,42,0.5185184993141296,0.48148146364883465
2024-12-27,세진중공업,1,1,0,2,0.499999750000125,0.499999750000125
2024-12-27,한국카본,2,0,0,2,0.99999950000025,0.0
2024-12-27,한화엔진,9,5,1,15,0.6428570969387788,0.3571428316326549
2024-12-27,한화오션,23,16,17,56,0.5897435746219597,0.41025639973701544
2024-12-28,HD한국조선해양,1,3,1,5,0.24999993750001562,0.7499998125000469
2024-12-28,HD현대마린솔루션,0,1,0,1,0.0,0.9999990000010001
2024-12-28,HD현대마린엔진,0,1,0,1,0.0,0.9999990000010001
2024-12-28,HD현대미포,0,2,0,2,0.0,0.99999950000025
2024-12-28,HD현대중공업,1,4,2,7,0.199999960000008,0.799999840000032
2024-12-28,삼성중공업,1,2,2,5,0.33333322222225925,0.6666664444445185
2024-12-28,한화엔진,2,1,2,5,0.6666664444445185,0.33333322222225925
2024-12-28,한화오션,3,3,4,10,0.49999991666668053,0.49999991666668053
2024-12-29,HD한국조선해양,8,2,0,10,0.7999999200000081,0.19999998000000202
2024-12-29,HD현대마린솔루션,5,1,3,9,0.8333331944444675,0.16666663888889352
2024-12-29,HD현대미포,3,0,0,3,0.9999996666667778,0.0
2024-12-29,HD현대중공업,7,5,3,15,0.5833332847222263,0.41666663194444736
2024-12-29,STX엔진,2,1,0,3,0.6666664444445185,0.33333322222225925
2024-12-29,삼성중공업,12,5,1,18,0.7058823114186875,0.2941176297577865
2024-12-29,세진중공업,1,1,0,2,0.499999750000125,0.499999750000125
2024-12-29,한국카본,0,1,0,1,0.0,0.9999990000010001
2024-12-29,한화엔진,2,0,1,3,0.99999950000025,0.0
2024-12-29,한화오션,8,7,2,17,0.5333332977777802,0.46666663555555765
2024-12-30,HD한국조선해양,13,10,8,31,0.5652173667296797,0.4347825897920613
2024-12-30,HD현대마린솔루션,5,2,1,8,0.7142856122449125,0.285714244897965
2024-12-30,HD현대마린엔진,3,0,1,4,0.9999996666667778,0.0
2024-12-30,HD현대미포,10,0,9,19,0.99999990000001,0.0
2024-12-30,HD현대중공업,21,14,15,50,0.5999999828571434,0.39999998857142893
2024-12-30,삼성중공업,15,8,6,29,0.6521738846880919,0.34782607183364905
2024-12-30,세진중공업,1,0,0,1,0.9999990000010001,0.0
2024-12-30,한국카본,0,0,4,4,0.0,0.0
2024-12-30,한화엔진,6,2,3,11,0.7499999062500118,0.24999996875000394
2024-12-30,한화오션,32,12,20,64,0.7272727107438021,0.27272726652892576
2024-12-31,HD한국조선해양,10,7,5,22,0.588235259515573,0.4117646816609011
2024-12-31,HD현대마린솔루션,4,2,1,7,0.6666665555555741,0.33333327777778704
2024-12-31,HD현대마린엔진,0,0,1,1,0.0,0.0
2024-12-31,HD현대미포,9,2,6,17,0.8181817438016598,0.1818181652892577
2024-12-31,HD현대중공업,14,5,6,25,0.7368420664819965,0.26315788088642733
2024-12-31,삼성중공업,11,6,5,22,0.6470587854671302,0.35294115570934376
2024-12-31,한화엔진,4,1,1,6,0.799999840000032,0.199999960000008
2024-12-31,한화오션,22,5,6,33,0.8148147846364894,0.18518517832647488
